author:	Mlewandowska
date:	2019-08-02 19:21	2019-08-03 19:23
concentration = 0.15, size: 300x300
distribution: Gauss	scale: 1.0
init_number_X = 50, init_number_Y = 13500	n_links = 0
k1 = 1, k2 = 1, beta = 0, lambd = 0.7
number of simulations k = 25, number of iterations n = 5000
range sampling: [0, 5, 10, 20, 30, 40, 50, 60, 70, 80, 90, 100, 110, 120, 130, 140, 150]

0,1,11,34,62,84,118,151,169,203,246,275,298,316,339,362,385,
0,1,10,34,56,85,105,124,148,169,196,219,248,271,294,317,344,
0,1,11,33,51,77,105,133,154,179,200,248,268,294,325,352,383,
0,1,9,30,51,81,104,135,154,177,216,239,262,282,302,323,364,
0,1,7,31,50,71,92,125,148,171,193,222,243,265,287,322,341,
0,1,8,33,57,80,107,131,164,189,211,229,256,280,304,323,353,
0,1,9,31,51,71,92,114,151,166,191,210,236,265,305,331,357,
0,1,8,28,45,71,90,112,146,180,202,226,242,275,301,338,360,
0,1,11,32,50,68,91,109,126,157,186,212,236,258,280,305,329,
0,1,7,24,56,86,103,127,151,174,207,233,262,285,311,336,366,
0,1,8,30,51,68,101,125,149,171,198,225,249,274,299,335,380,
0,1,11,31,49,72,94,118,144,176,215,240,277,301,332,362,383,
0,1,9,28,46,71,100,148,173,206,241,274,294,326,355,382,407,
0,1,11,29,51,72,93,116,141,163,185,207,226,264,294,316,332,
0,1,9,30,52,75,101,121,143,164,189,225,249,270,308,335,366,
0,1,9,31,59,78,97,121,143,192,216,242,269,291,317,355,381,
0,1,10,33,83,110,132,160,194,222,247,276,296,319,338,377,404,
0,1,7,32,61,85,107,140,159,246,269,297,326,352,438,469,494,
0,1,14,32,64,93,113,138,179,210,235,259,282,302,339,364,390,
0,1,9,30,50,68,97,124,168,186,212,232,258,282,307,334,371,
0,1,9,32,54,110,132,163,184,208,228,253,275,309,364,388,425,
0,1,10,29,48,73,93,116,162,192,219,249,268,300,322,354,384,
0,1,6,30,53,87,112,129,156,182,204,236,266,288,328,348,377,
0,1,8,35,53,75,96,135,154,183,213,239,268,291,320,354,376,
0,1,11,35,59,78,100,130,148,178,202,234,260,286,314,340,368,
0,1,9,27,44,62,84,110,141,176,198,238,263,300,322,352,377,
0,1,9,33,52,73,88,125,145,163,190,210,237,266,292,330,368,
0,1,10,32,69,94,122,144,165,191,216,278,299,333,357,376,439,
0,1,8,27,49,72,104,125,149,170,198,239,262,296,322,353,380,
0,1,9,36,58,77,123,154,177,212,236,259,287,312,333,361,410,
0,1,8,29,52,75,97,127,155,184,221,241,265,285,307,331,361,
0,1,7,32,56,76,101,121,146,167,216,242,264,293,320,341,368,
0,1,8,27,55,79,111,129,153,175,205,229,251,270,290,314,333,
0,1,10,51,71,96,112,131,166,190,213,237,263,285,328,351,387,
0,1,10,26,53,75,103,138,160,180,207,236,266,290,317,340,366,
0,1,10,37,56,80,103,130,156,186,206,229,249,268,294,318,342,
0,1,9,38,60,81,103,124,159,184,249,275,308,336,363,382,408,
0,1,9,31,49,77,101,129,149,172,195,219,255,289,313,340,369,
0,1,9,33,51,68,92,119,143,168,194,228,250,284,319,344,381,
0,1,7,31,62,87,123,148,169,193,218,253,277,313,342,364,394,
0,1,10,33,63,86,110,143,161,190,208,230,249,272,298,343,368,
0,1,10,34,71,97,124,146,165,185,230,263,298,319,339,357,410,
0,1,11,31,52,77,94,114,142,168,220,238,260,287,313,338,363,
0,1,8,27,51,68,89,108,129,149,177,219,248,273,291,319,354,
0,1,9,29,49,74,100,122,144,190,216,252,278,309,333,358,391,
0,1,9,43,65,90,112,137,162,188,209,244,266,286,313,359,377,
0,1,7,30,50,76,98,112,145,171,197,222,246,273,298,321,345,
0,1,9,33,52,116,144,167,191,219,241,269,290,319,348,366,393,
0,1,7,30,58,86,108,129,166,190,211,233,264,290,337,355,397,
0,1,9,33,52,89,110,141,167,203,233,256,278,300,325,361,384,
0,1,12,36,58,80,99,124,145,191,223,246,266,289,316,349,381,
0,1,9,32,60,79,125,167,189,210,238,262,283,310,339,374,395,
0,1,10,33,56,76,105,136,171,192,213,236,258,279,303,327,356,
0,1,9,41,
0,1,9,29,49,74,96,119,142,163,185,210,239,263,288,308,338,
0,1,10,28,52,74,100,121,141,167,188,215,242,258,291,312,338,
0,1,9,32,51,84,106,129,156,218,238,256,276,321,343,375,404,
0,1,11,32,66,90,116,147,175,194,213,245,266,284,317,338,374,
0,1,8,30,55,79,100,134,159,178,200,222,238,275,304,332,363,
0,1,11,33,61,91,119,143,175,195,222,249,274,293,323,345,388,
0,1,12,34,69,97,137,163,199,224,287,325,346,373,397,420,442,
0,1,14,32,56,77,107,130,165,186,214,239,258,290,310,331,352,
0,1,8,27,
0,1,9,32,51,69,90,113,137,156,181,202,222,251,269,337,358,
0,1,10,31,57,80,103,131,153,182,201,236,260,288,329,350,374,
0,1,8,33,53,80,109,132,149,165,198,223,245,265,296,351,368,
0,1,8,33,58,83,112,131,156,178,199,220,244,266,304,329,367,
0,1,10,35,54,77,99,119,139,162,189,215,245,270,294,336,360,
0,1,9,29,85,131,203,225,258,290,317,338,364,409,429,452,475,
0,1,8,28,55,86,116,143,163,197,226,253,287,304,339,359,381,
0,1,9,32,55,86,115,148,170,193,221,246,266,283,304,324,344,
0,1,11,29,47,69,96,120,143,172,210,238,263,289,326,348,375,
0,1,7,27,64,82,112,132,160,182,212,241,267,289,312,333,359,
0,1,7,24,67,84,114,144,167,195,221,247,269,296,318,339,388,
0,1,11,32,56,80,99,129,156,186,213,235,281,331,357,380,401,
0,1,9,34,53,75,110,140,163,185,214,237,265,303,325,359,382,
0,1,10,37,57,83,105,126,166,187,205,231,251,274,295,327,347,
0,1,9,29,50,73,96,123,140,166,193,215,235,259,283,309,328,
0,1,9,37,61,79,104,121,143,161,183,201,230,291,330,350,372,
0,1,11,37,57,79,98,130,162,190,216,236,262,321,339,363,383,
0,1,8,27,49,73,95,123,154,181,206,227,253,276,299,332,355,
0,1,10,39,61,82,109,130,153,180,201,215,252,280,322,349,379,
0,1,8,29,59,83,107,130,152,176,198,226,251,271,290,311,328,
0,1,8,29,61,90,120,143,165,187,210,235,255,309,333,368,399,
0,1,12,33,56,87,114,133,166,190,211,241,284,302,324,341,359,
0,1,9,29,53,73,97,124,154,177,199,224,244,268,314,338,366,
0,1,7,26,48,76,110,138,159,180,202,225,245,282,329,354,402,
0,1,7,33,58,86,117,142,179,206,237,257,293,324,349,372,405,
0,1,9,28,54,80,104,125,147,172,197,220,240,261,280,296,343,
0,1,7,47,
0,1,9,29,46,70,101,137,156,203,230,253,275,296,322,352,383,
0,1,16,38,59,82,107,127,147,172,191,221,239,266,293,318,342,
0,1,10,35,63,85,105,133,177,195,217,241,279,342,369,394,424,
0,1,10,31,60,80,104,130,148,168,186,208,231,253,296,315,365,
0,1,9,28,53,79,102,126,148,173,198,218,244,272,294,324,342,
0,1,10,40,61,82,106,133,159,178,208,232,254,286,313,335,363,
0,1,8,31,52,82,103,135,164,190,213,234,271,298,317,336,361,
0,1,11,34,54,84,111,132,158,178,208,225,245,283,308,332,370,
0,1,9,31,51,76,96,117,140,161,181,208,241,264,286,312,330,
0,1,8,34,59,80,106,130,156,180,208,230,251,280,299,338,362,
0,1,7,26,49,80,107,124,147,176,198,221,250,285,303,336,383,
0,1,10,33,58,82,112,136,154,197,221,240,262,283,323,351,393,
0,1,10,34,57,76,103,128,152,178,204,225,244,270,294,324,352,
0,1,7,29,55,79,106,125,147,173,206,225,258,282,314,345,382,
0,1,11,30,51,75,102,123,151,176,197,221,239,269,290,319,346,
0,1,17,39,56,79,117,148,176,192,236,281,325,346,381,406,424,
0,1,9,30,54,76,93,125,150,174,205,226,249,274,300,318,374,
0,1,7,29,56,81,100,120,144,174,200,220,241,260,322,341,367,
0,1,11,36,56,79,108,131,152,175,195,221,240,272,298,317,342,
0,1,9,33,55,80,105,125,158,184,208,243,265,291,309,335,357,
0,1,9,26,44,70,98,137,161,182,208,246,281,309,335,364,384,
0,1,9,30,52,69,88,117,146,176,198,220,241,300,318,341,369,
0,1,11,30,52,87,139,163,184,231,266,286,316,337,364,387,413,
0,1,10,32,56,101,127,152,176,197,222,242,275,300,324,348,374,
0,1,9,28,51,68,90,110,134,159,187,231,269,300,342,372,398,
0,1,10,31,51,80,101,120,148,170,192,215,235,254,303,320,356,
0,1,8,28,57,77,104,122,159,191,214,245,285,325,343,365,390,
0,1,9,28,56,73,97,134,170,201,224,251,282,310,329,354,373,
0,1,9,31,48,71,99,129,152,176,211,240,269,302,325,347,372,
0,1,9,31,63,88,107,136,181,212,238,283,309,332,351,382,401,
0,1,10,35,56,80,100,119,157,178,219,246,277,311,334,357,378,
0,1,11,29,48,68,104,128,148,173,201,222,242,264,290,320,339,
0,1,11,30,54,74,103,129,155,181,201,221,250,277,300,331,355,
0,1,7,33,53,100,127,150,169,191,208,238,259,277,303,331,363,
0,1,9,33,55,83,110,141,156,184,204,226,252,291,312,340,370,
0,1,8,32,63,85,108,134,154,180,208,228,248,280,304,338,359,
0,1,10,32,50,73,100,129,153,180,205,226,248,275,298,327,382,
0,1,11,33,60,81,101,128,153,194,214,248,271,307,329,359,378,
0,1,9,24,50,76,99,124,148,168,189,208,253,283,300,331,368,
0,1,11,30,57,80,103,126,156,179,203,241,268,287,315,339,359,
0,1,8,29,50,76,106,126,153,188,213,241,260,290,309,340,369,
0,1,9,29,51,68,102,121,140,164,193,214,233,258,283,305,349,
0,1,10,32,58,82,101,127,171,201,221,245,266,295,330,359,385,
0,1,10,31,54,78,104,136,164,192,213,242,263,284,308,353,380,
0,1,7,28,52,76,100,122,146,166,191,226,265,283,315,338,361,
0,1,10,35,77,99,132,161,190,215,236,258,279,298,320,363,387,
0,1,10,36,59,81,108,128,150,172,211,239,263,289,314,358,389,
0,1,8,34,58,80,107,127,152,181,213,234,257,275,316,369,398,
0,1,11,31,51,75,95,118,140,160,185,214,235,263,285,318,337,
0,1,9,
0,1,10,31,52,77,96,120,142,159,183,206,227,260,298,328,358,
0,1,9,41,66,102,123,141,181,202,225,247,272,298,317,339,358,
0,1,10,40,61,82,106,133,159,178,208,232,254,286,313,335,363,
0,1,8,31,52,82,103,135,164,190,213,234,271,298,317,336,361,
0,1,11,34,54,84,111,132,158,178,208,225,245,283,308,332,370,
0,1,9,31,51,76,96,117,140,161,181,208,241,264,286,312,330,
0,1,8,34,59,80,106,130,156,180,208,230,251,280,299,338,362,
0,1,7,26,49,80,107,124,147,176,198,221,250,285,303,336,383,
0,1,10,33,58,82,112,136,154,197,221,240,262,283,323,351,393,
0,1,10,34,57,76,103,128,152,178,204,225,244,270,294,324,352,
0,1,7,29,55,79,106,125,147,173,206,225,258,282,314,345,382,
0,1,11,30,51,75,102,123,151,176,197,221,239,269,290,319,346,
0,1,11,33,55,80,106,127,151,178,200,219,236,267,286,305,341,
0,1,8,39,58,78,110,218,259,280,303,328,351,381,403,425,454,
0,1,11,32,57,80,106,131,156,173,194,220,245,273,303,330,364,
0,1,11,30,54,75,110,129,155,177,203,229,247,271,290,320,338,
0,1,9,32,52,77,106,126,152,182,210,228,256,285,307,327,348,
0,1,8,32,53,73,95,117,157,186,204,223,248,275,300,327,350,
0,1,11,43,137,175,196,220,244,271,302,323,348,371,395,419,439,
0,1,8,30,50,68,87,113,136,154,172,192,229,250,276,314,333,
0,1,6,24,48,73,104,127,146,177,210,241,279,305,325,344,388,
0,1,9,30,49,75,103,125,149,168,190,217,247,276,313,333,360,
0,1,8,32,57,79,97,123,149,174,205,229,259,282,321,350,377,
0,1,9,30,47,73,101,134,160,189,212,240,272,296,318,341,361,
0,1,7,31,51,75,94,109,142,170,190,213,246,271,301,330,350,
0,1,11,35,50,79,104,129,159,196,219,238,268,310,338,356,378,
0,1,8,27,44,69,90,113,144,166,187,216,240,263,295,323,352,
0,1,9,34,56,76,100,123,147,173,204,233,252,276,295,322,347,
0,1,8,28,61,79,103,121,144,162,184,228,249,273,294,336,363,
0,1,12,34,57,86,108,125,147,172,194,235,257,285,307,336,363,
0,1,10,34,56,100,125,148,189,214,241,263,287,309,335,356,374,
0,1,9,29,56,74,102,125,149,176,194,219,243,276,298,317,337,
0,1,7,29,53,78,105,131,155,175,199,226,266,290,312,335,378,
0,1,10,35,56,76,94,114,159,189,207,243,284,303,328,350,372,
0,1,11,31,54,86,107,127,155,173,197,219,242,263,286,304,331,
0,1,8,32,58,84,113,133,152,172,193,219,254,276,312,334,367,
0,1,6,23,56,83,103,121,152,173,205,224,249,294,314,334,359,
0,1,13,33,54,78,104,123,148,176,210,241,259,277,301,333,357,
0,1,10,28,52,72,97,120,142,168,189,209,228,251,274,296,322,
0,1,10,33,57,76,110,131,152,192,228,246,284,314,337,359,383,
0,1,11,30,48,86,110,128,150,185,214,235,255,276,306,323,348,
0,1,9,28,49,71,101,133,162,200,253,290,318,341,385,410,432,
0,1,10,31,52,82,110,138,172,192,213,235,269,289,330,355,378,
0,1,10,36,60,78,100,125,144,168,196,220,246,268,287,310,329,
0,1,6,32,55,79,109,129,154,180,201,225,245,278,305,334,358,
0,1,11,37,59,82,102,147,173,193,213,230,256,280,306,325,346,
0,1,10,30,50,68,100,119,140,161,181,203,235,278,306,331,359,
0,1,7,32,54,72,94,132,154,173,193,215,235,266,290,311,384,
0,1,10,30,49,70,96,146,168,206,232,285,305,331,360,384,412,
0,1,9,28,50,67,87,111,133,161,184,206,242,271,293,340,373,
0,1,7,29,50,80,98,115,144,165,184,215,235,278,302,356,380,
0,1,10,31,55,76,105,120,143,165,195,214,237,258,282,304,344,
0,1,9,31,51,75,97,114,151,174,208,240,262,281,302,340,359,
0,1,8,32,58,80,104,129,153,180,209,239,259,279,309,337,372,
0,1,9,34,64,87,110,136,179,207,243,268,296,331,350,383,425,
0,1,7,31,69,91,115,138,162,194,216,243,272,294,326,346,377,
0,1,8,29,46,70,90,117,142,160,183,219,243,266,291,315,335,
0,1,8,31,55,82,99,122,145,169,191,210,238,267,293,322,354,
0,1,7,27,46,76,99,137,163,191,217,240,261,285,311,340,371,
0,1,10,32,52,74,97,116,137,159,192,223,244,271,313,339,367,
0,1,6,28,48,71,105,133,152,173,201,229,248,276,302,335,375,
0,1,11,28,49,68,91,112,139,164,182,210,245,270,311,346,376,
0,1,9,24,56,85,105,134,153,171,200,230,256,281,306,329,358,
0,1,7,35,67,91,115,144,167,198,220,243,263,285,309,368,414,
0,1,10,30,51,93,133,158,217,251,277,302,323,353,370,403,430,
0,1,7,29,51,76,107,127,153,176,200,234,256,272,297,346,364,
0,1,9,28,46,77,97,119,144,177,198,222,250,280,300,322,341,
0,1,10,36,54,77,110,148,180,207,230,252,270,298,321,344,369,
0,1,10,35,58,81,111,135,159,178,202,226,245,279,308,327,347,
0,1,9,34,53,83,114,143,168,197,216,249,279,302,334,359,377,
0,1,11,29,57,80,115,139,167,188,214,242,266,288,314,335,363,
0,1,8,30,53,76,102,121,162,184,208,230,248,284,315,338,365,
0,1,9,36,66,87,108,126,145,174,196,230,247,301,327,355,378,
0,1,8,30,55,82,101,120,140,167,194,214,239,266,291,335,355,
0,1,11,32,54,80,107,131,167,187,203,233,257,303,322,369,389,
0,1,9,30,54,82,108,129,148,169,194,222,250,268,293,318,349,
0,1,11,35,58,80,97,122,144,168,214,241,263,294,319,345,382,
0,1,8,33,61,83,111,130,157,178,199,220,238,260,299,327,353,
0,1,7,42,64,84,114,135,169,198,226,249,276,299,333,351,371,
0,1,9,39,64,85,112,136,158,190,220,247,269,289,311,333,357,
0,1,8,27,49,73,99,119,145,164,212,229,264,285,304,362,381,
0,1,8,32,54,76,101,126,154,182,203,228,261,288,318,339,374,
0,1,6,32,54,79,99,124,144,165,188,224,245,280,304,329,356,
0,1,12,34,54,87,114,135,155,178,196,223,248,269,292,313,346,
0,1,10,28,63,86,106,135,158,190,210,232,252,285,306,334,360,
0,1,9,37,57,82,106,129,152,175,197,220,248,273,299,325,343,
0,1,9,30,48,68,96,118,149,195,217,257,278,297,317,344,364,
0,1,10,31,52,69,92,113,142,169,191,214,242,261,276,310,337,
0,1,11,36,63,81,108,127,148,195,226,253,275,297,318,344,359,
0,1,5,26,60,81,110,145,164,185,226,252,276,308,327,353,381,
0,1,11,39,70,97,114,134,166,192,220,241,278,313,338,357,385,
0,1,8,26,46,73,95,126,146,173,205,234,257,285,305,324,357,
0,1,12,34,58,82,105,128,146,180,207,243,269,292,317,338,355,
0,1,8,29,62,88,112,137,158,176,195,214,235,259,312,332,356,
0,1,8,29,67,108,133,154,174,198,248,272,291,318,360,382,402,
0,1,10,33,53,76,103,180,208,239,267,298,316,339,359,379,403,
0,1,8,31,56,75,94,122,145,168,190,213,249,267,289,307,333,
0,1,10,43,67,90,115,139,157,177,197,225,260,285,305,327,349,
0,1,12,37,62,99,170,
0,1,9,26,48,66,86,106,127,149,176,196,239,265,285,306,324,
0,1,11,32,52,90,111,140,159,188,217,240,283,305,324,350,373,
0,1,9,28,49,69,88,110,130,154,185,214,228,257,290,327,346,
0,1,9,31,50,76,102,125,150,176,198,222,263,283,306,328,350,
0,1,10,30,54,74,105,131,153,177,207,228,255,291,318,332,381,
0,1,9,28,50,74,98,124,166,188,215,244,271,293,310,363,397,
0,1,12,39,59,82,122,142,161,177,215,239,262,276,292,317,363,
0,1,8,33,54,74,109,155,175,198,237,267,293,318,346,372,396,
0,1,9,31,64,98,120,194,227,248,
0,1,8,29,53,74,96,126,154,194,222,248,274,297,321,345,396,
0,1,10,29,55,84,108,132,161,182,202,226,247,271,293,316,341,
0,1,7,29,47,71,94,113,150,170,206,239,265,287,308,330,350,
0,1,10,30,52,79,105,129,153,176,201,224,258,286,320,347,379,
0,1,10,32,51,73,103,129,153,176,203,225,252,273,302,337,379,
0,1,7,29,51,73,95,127,150,176,198,223,243,271,294,323,343,
0,1,8,33,59,85,110,132,156,174,200,241,262,283,327,352,373,
0,1,7,23,45,76,99,120,150,196,217,255,285,310,332,354,376,
0,1,10,33,56,81,100,125,154,176,203,239,268,288,310,340,367,
0,1,7,29,60,82,108,132,153,179,206,225,244,267,299,322,344,
0,1,9,28,51,76,104,134,156,175,238,300,320,364,388,461,482,
0,1,10,35,74,97,130,160,184,207,224,247,285,302,332,355,386,
0,1,11,37,59,101,138,160,189,211,236,256,276,311,333,355,375,
0,1,7,25,53,84,104,129,150,169,193,212,246,269,293,314,340,
0,1,8,30,47,68,105,123,149,166,185,236,257,282,306,333,363,
0,1,8,34,53,71,92,113,135,159,180,201,220,244,271,307,332,
0,1,8,32,51,76,103,126,155,179,205,248,268,300,320,341,361,
0,1,9,30,49,69,90,112,134,163,190,211,232,250,273,298,324,
0,1,8,30,51,74,101,130,147,171,197,240,257,295,321,340,373,
0,1,10,29,49,70,95,114,140,162,192,213,250,279,300,341,370,
0,1,11,29,49,69,91,125,161,181,204,228,250,270,295,319,342,
0,1,10,32,52,77,99,123,148,165,194,217,241,273,297,321,351,
0,1,8,35,55,80,105,130,158,187,217,237,261,285,308,331,353,
0,1,11,27,52,76,96,131,150,171,194,212,229,262,293,314,334,
0,1,7,30,52,76,93,117,144,164,195,216,237,257,278,316,351,
0,1,7,33,57,77,104,126,144,185,209,254,274,299,336,361,384,
0,1,13,40,66,97,115,135,208,239,260,285,304,325,351,389,410,
0,1,9,25,50,75,93,114,144,175,204,228,260,282,308,333,357,
0,1,11,32,51,74,100,120,148,175,196,227,255,278,305,355,374,
0,1,10,28,51,77,102,132,160,186,202,219,235,260,281,300,319,
0,1,11,33,55,81,106,124,147,170,193,223,247,266,286,313,334,
0,1,12,30,49,78,100,124,142,165,202,221,238,263,284,303,349,
0,1,8,32,56,77,99,129,160,188,211,235,253,275,292,316,338,
0,1,9,32,59,84,104,128,154,175,200,218,257,274,304,344,365,
0,1,7,27,49,77,95,120,143,164,186,204,225,241,279,303,351,
0,1,9,29,46,64,97,139,161,181,201,227,260,285,306,338,360,
0,1,9,35,63,88,112,135,155,181,219,247,274,310,337,356,376,
0,1,12,35,50,71,93,122,151,171,194,221,253,278,302,320,346,
0,1,9,29,54,83,109,131,151,177,193,224,243,270,298,325,343,
0,1,9,27,46,77,94,121,152,184,223,246,270,295,326,346,368,
0,1,9,28,44,69,98,122,148,165,199,226,259,286,315,346,364,
0,1,10,28,49,84,108,129,152,174,199,220,243,267,289,316,338,
0,1,9,29,51,71,89,114,138,161,179,204,226,247,296,322,343,
0,1,8,28,52,74,93,125,154,178,201,218,252,273,301,328,353,
0,1,10,30,55,75,104,129,164,188,217,258,283,309,342,367,402,
0,1,9,27,52,73,101,118,137,170,189,212,243,262,303,329,347,
0,1,8,31,53,75,98,126,169,189,221,243,268,292,316,345,373,
0,1,10,29,49,66,87,104,138,158,197,219,239,258,282,321,346,
0,1,9,32,59,84,108,134,163,194,220,253,278,314,336,359,382,
0,1,12,
0,2,10,36,53,78,104,127,151,175,195,225,247,270,288,310,340,
0,1,10,31,56,79,152,182,210,255,286,311,331,355,380,401,430,
0,1,9,32,54,81,128,152,178,205,227,250,282,353,371,401,421,
0,1,8,28,51,75,95,116,136,156,189,210,240,260,289,318,349,
0,1,11,41,59,82,108,134,158,178,208,232,262,280,305,328,367,
0,1,10,31,51,72,111,134,153,176,244,272,295,321,345,371,394,
0,1,8,32,56,79,101,135,181,206,233,256,276,318,338,358,387,
0,1,12,38,62,92,115,150,173,196,227,253,291,317,340,364,382,
0,1,12,34,59,81,110,138,158,181,205,227,251,279,322,343,373,
0,1,9,36,57,80,104,126,149,169,188,222,248,271,293,329,368,
0,1,7,29,55,73,92,122,150,176,196,243,274,299,331,375,414,
0,1,8,36,60,82,104,145,165,184,207,239,264,287,314,347,391,
0,1,9,28,54,80,106,127,154,179,201,229,263,283,312,338,361,
0,1,10,32,55,76,98,126,143,162,187,216,239,258,277,300,337,
0,1,13,33,50,80,121,155,174,192,213,255,276,316,333,359,382,
0,1,12,43,69,106,125,158,174,190,230,264,282,309,343,374,400,
0,1,9,31,54,87,108,133,159,184,203,234,255,279,305,350,372,
0,1,11,34,51,72,97,123,146,167,187,213,258,278,306,331,356,
0,1,11,34,54,78,105,127,147,175,197,222,246,279,301,325,349,
0,1,9,33,70,97,116,149,195,215,242,263,291,354,376,403,426,
0,1,8,30,53,83,126,146,169,212,236,261,283,307,330,364,391,
0,1,8,28,52,75,96,126,156,180,204,226,247,273,309,330,354,
0,1,10,29,54,77,99,124,146,168,190,205,223,272,292,314,341,
0,1,12,37,53,77,110,135,167,188,211,228,254,288,312,352,384,
0,1,8,32,50,71,95,120,140,173,194,232,260,282,308,330,353,
0,1,11,33,53,77,104,125,153,173,201,229,256,282,308,328,355,
0,1,7,32,60,83,98,131,163,203,225,249,269,295,316,336,376,
0,1,8,33,56,79,98,121,143,172,197,218,244,265,288,314,333,
0,1,12,39,68,87,117,145,166,198,219,244,266,287,311,355,379,
0,1,10,32,60,82,115,136,160,183,203,228,252,275,304,323,367,
0,1,10,36,57,79,101,133,165,191,214,240,261,287,320,338,364,
0,1,12,35,54,76,100,121,140,166,207,229,264,285,311,336,361,
0,1,7,31,52,85,109,137,159,189,214,236,253,274,297,340,363,
0,1,10,34,55,78,109,145,164,186,208,231,253,271,291,311,337,
0,1,10,34,58,82,102,124,145,170,189,225,247,276,303,324,345,
0,1,8,37,60,89,107,132,152,175,195,215,243,266,285,311,335,
0,1,9,34,58,82,104,124,160,180,207,228,259,285,311,342,370,
0,1,7,37,55,81,104,129,155,176,199,222,249,267,302,323,345,
0,1,8,32,50,71,89,116,139,160,186,211,234,249,272,290,309,
0,1,9,34,53,75,104,125,143,173,222,242,262,287,310,336,363,
0,1,7,34,55,80,120,140,158,182,216,239,262,279,314,332,363,
0,1,9,39,64,82,106,138,159,184,206,229,254,278,302,330,351,
0,1,11,38,78,97,124,154,185,206,236,261,302,335,357,381,400,
0,1,8,33,52,76,101,124,144,160,188,216,251,274,295,317,358,
0,1,8,31,54,68,99,118,141,161,182,203,225,249,270,291,308,
0,1,7,28,49,72,95,116,135,156,175,204,224,247,270,305,328,
0,1,9,35,60,82,108,129,150,184,202,222,310,340,371,397,430,
0,1,11,66,90,112,147,175,210,250,288,317,344,369,396,418,439,
0,1,9,27,43,77,96,120,162,184,225,251,298,321,342,383,406,
0,1,10,32,57,81,104,128,157,178,202,226,259,290,319,340,368,
0,1,10,27,52,74,96,127,156,175,202,224,255,276,296,321,341,
0,1,10,27,53,73,98,120,143,164,188,209,237,268,303,324,358,
