author:	Mlewandowska
date:	2019-08-02 19:19	2019-08-05 15:51
concentration = 0.15, size: 300x300
distribution: Gauss	scale: 1.0
init_number_X = 50, init_number_Y = 13500	n_links = 0
k1 = 1, k2 = 1, beta = 0, lambd = 0.5
number of simulations k = 25, number of iterations n = 5000
range sampling: [0, 5, 10, 20, 30, 40, 50, 60, 70, 80, 90, 100, 110, 120, 130, 140, 150]

0,1,17,
0,1,12,38,88,111,183,222,299,325,369,440,498,531,602,644,837,
0,1,11,41,89,130,164,189,224,255,284,315,368,406,504,589,676,
0,1,14,41,83,109,140,166,194,289,338,381,416,445,493,529,559,
0,1,14,39,81,116,150,228,285,335,419,443,471,
0,1,11,42,71,110,141,170,202,250,285,307,345,381,420,470,499,
0,1,11,43,69,137,170,
0,1,13,46,83,133,176,211,255,439,475,508,552,577,613,643,681,
0,1,9,47,95,169,
0,1,16,67,96,142,174,195,215,257,300,347,385,483,551,576,609,
0,1,21,69,
0,1,11,40,91,125,177,275,315,371,447,488,519,555,582,615,647,
0,1,12,37,94,135,178,206,238,281,324,375,404,429,469,515,548,
0,1,10,38,72,108,135,183,217,251,299,325,367,455,475,558,588,
0,1,12,40,73,103,126,173,201,244,302,357,391,437,469,505,576,
0,1,22,67,124,
0,1,11,
0,1,13,39,95,116,148,179,251,276,316,342,
0,1,15,45,77,
0,1,16,50,91,134,
0,1,12,42,91,129,177,
0,1,12,58,102,134,
0,1,16,50,82,106,135,224,271,354,415,446,
0,1,8,
0,1,12,41,87,114,138,167,
0,1,12,42,101,138,172,206,245,283,320,493,548,613,646,780,811,
0,1,12,59,112,
0,1,12,43,79,123,148,204,246,275,
0,1,12,47,84,107,139,176,215,264,314,343,381,454,
0,1,14,37,81,120,167,189,252,305,335,364,393,463,
0,1,20,53,85,119,157,
0,1,11,42,64,97,159,197,222,246,276,309,351,392,423,452,492,
0,1,19,50,90,117,163,197,248,275,320,362,434,472,605,631,672,
0,1,11,38,64,106,136,188,214,246,292,517,556,584,
0,1,10,48,82,107,142,193,227,257,284,311,367,397,439,491,530,
0,1,11,38,80,116,151,214,283,329,355,396,491,
0,1,15,47,82,145,
0,1,13,42,76,115,155,194,291,329,376,489,536,572,
0,1,15,43,69,107,138,174,235,260,291,327,369,440,484,530,
0,1,20,66,
0,1,11,42,77,108,187,215,281,311,352,383,422,460,520,560,598,
0,1,17,48,91,129,177,206,243,271,302,337,410,516,560,584,634,
0,1,12,45,77,118,162,203,233,257,308,347,376,419,449,555,580,
0,1,11,39,73,104,154,189,233,265,293,323,546,587,622,670,741,
0,1,12,51,75,138,176,210,230,262,293,331,407,442,485,516,542,
0,1,19,57,95,120,200,
0,1,14,49,92,123,144,178,235,268,301,326,361,427,453,475,546,
0,1,11,40,72,117,159,223,283,
0,1,14,39,107,133,183,219,272,307,336,377,408,450,484,526,584,
0,1,14,44,86,112,151,281,309,340,359,397,428,471,499,590,620,
0,1,14,52,82,119,146,195,231,
0,1,15,48,79,108,157,180,212,243,273,299,343,369,395,424,455,
0,1,12,59,
0,1,13,48,86,144,183,207,250,
0,1,11,47,78,114,156,178,219,252,315,388,418,464,508,536,579,
0,1,15,49,83,114,144,177,199,223,
0,1,11,47,68,112,142,161,247,283,313,363,417,489,524,613,
0,1,12,45,71,110,136,179,207,233,277,317,343,456,505,564,590,
0,1,10,48,78,
0,1,17,58,105,168,197,221,388,507,533,595,617,647,695,
0,1,13,41,70,126,154,192,239,279,314,351,380,412,436,
0,1,14,44,79,117,159,221,244,284,323,362,397,435,610,662,692,
0,1,12,71,94,160,179,207,230,285,400,429,456,638,671,689,722,
0,1,6,46,66,99,128,163,191,242,292,320,364,
0,1,14,40,71,106,209,231,301,407,434,462,511,539,572,
0,1,12,52,79,105,209,237,264,316,371,413,503,540,586,615,654,
0,1,9,37,71,116,145,178,202,228,263,311,397,434,
0,1,13,37,80,116,136,205,239,273,306,361,409,431,456,551,701,
0,1,17,
0,1,27,57,95,115,192,230,287,326,366,399,428,493,577,625,671,
0,1,
0,1,9,44,72,118,163,201,236,283,392,422,444,479,529,563,685,
0,1,14,42,75,114,153,198,234,257,318,350,387,419,465,503,552,
0,1,12,49,94,120,180,233,254,294,322,358,385,416,452,499,522,
0,1,16,47,77,109,138,232,294,337,384,432,472,515,567,650,693,
0,1,12,42,101,138,172,206,245,283,320,493,548,613,646,780,811,
0,1,12,59,112,
0,1,12,43,79,123,148,204,246,275,
0,1,12,47,84,107,139,176,215,264,314,343,381,454,
0,1,14,37,81,120,167,189,252,305,335,364,393,463,
0,1,11,37,72,104,135,188,215,290,322,356,391,430,488,529,654,
0,1,13,54,
0,1,16,47,77,116,142,178,252,371,
0,1,14,47,75,108,134,188,211,283,317,353,383,428,479,572,595,
0,1,8,47,72,110,146,175,209,245,283,325,372,405,430,499,524,
0,1,12,38,81,115,140,177,248,281,
0,1,15,50,80,
0,1,12,38,100,138,175,217,319,
0,1,15,50,83,107,165,207,238,293,321,356,382,417,527,574,601,
0,1,13,46,89,119,156,182,211,260,301,329,406,428,453,492,
0,1,13,41,70,126,154,192,239,279,314,351,380,412,436,
0,1,14,44,79,117,159,221,244,284,323,362,397,435,610,662,692,
0,1,12,71,94,160,179,207,230,285,400,429,456,638,671,689,722,
0,1,6,46,66,99,128,163,191,242,292,320,364,
0,1,12,38,81,115,140,177,248,281,
0,1,15,50,80,
0,1,12,38,100,138,175,217,319,
0,1,15,50,83,107,165,207,238,293,321,356,382,417,527,574,601,
0,1,13,46,89,119,156,182,211,260,301,329,406,428,453,492,
0,1,12,42,101,138,172,206,245,283,320,493,548,613,646,780,811,
0,1,12,59,112,
0,1,12,43,79,123,148,204,246,275,
0,1,12,47,84,107,139,176,215,264,314,343,381,454,
0,1,14,37,81,120,167,189,252,305,335,364,393,463,
0,1,14,40,71,106,209,231,301,407,434,462,511,539,572,
0,1,
0,1,9,44,72,118,163,201,236,283,392,422,444,479,529,563,685,
0,1,14,42,75,114,153,198,234,257,318,350,387,419,465,503,552,
0,1,12,49,94,120,180,233,254,294,322,358,385,416,452,499,522,
0,1,16,47,77,109,138,232,294,337,384,432,472,515,567,650,693,
0,1,11,44,88,123,187,220,250,277,317,352,380,412,474,
0,1,12,66,122,156,185,215,255,293,324,360,422,475,502,541,581,
0,1,13,50,84,138,161,202,230,281,314,369,436,464,506,550,598,
0,1,17,50,81,118,180,
0,1,14,46,105,135,187,226,280,318,368,419,449,501,657,693,732,
0,1,15,52,84,115,149,262,297,343,368,403,457,
0,1,13,46,76,113,
0,1,12,33,66,
0,1,14,44,83,
0,1,10,35,67,116,150,190,219,274,
0,1,12,44,82,108,133,181,211,252,279,335,385,416,474,578,640,
0,1,15,47,87,107,143,191,223,289,333,375,437,526,564,616,675,
0,1,16,49,105,141,168,248,279,315,350,455,521,
0,1,13,56,85,116,139,205,
0,1,13,
0,1,12,46,119,160,184,218,289,321,349,384,577,
0,1,10,42,75,109,140,177,236,282,332,373,402,429,470,518,558,
0,1,12,45,94,
0,1,15,58,97,137,173,224,277,315,359,432,519,544,569,622,667,
0,1,12,53,94,118,151,185,450,489,568,
0,1,9,41,75,123,154,193,234,275,307,342,385,498,526,551,598,
0,1,15,50,87,121,147,206,246,315,387,
0,1,10,57,82,110,147,
0,1,13,50,80,125,160,192,246,294,339,
0,1,13,39,64,99,165,199,239,273,338,370,438,464,490,542,582,
0,1,12,44,76,104,132,199,221,
0,1,14,62,95,202,
0,1,12,38,80,113,198,226,257,285,316,407,457,507,565,594,662,
0,1,14,34,56,96,136,167,230,335,387,414,455,485,535,568,656,
0,1,10,42,79,105,138,194,231,262,295,325,350,375,402,431,475,
0,1,16,49,78,100,124,174,202,445,539,573,
0,1,14,46,74,104,148,179,213,247,296,359,391,427,470,516,
0,1,13,61,97,132,178,239,274,331,403,469,546,722,749,783,
0,1,16,45,81,112,145,175,210,250,302,338,402,446,480,559,603,
0,1,13,36,59,87,125,155,206,287,319,344,366,544,
0,1,14,40,71,112,151,
0,1,9,33,61,107,161,198,228,262,552,
0,1,15,36,124,174,208,250,286,328,362,387,427,450,502,558,597,
0,1,15,50,93,128,170,205,229,257,296,320,350,388,427,
0,1,11,42,84,117,153,232,262,299,326,353,
0,1,12,43,76,115,163,210,236,286,316,353,385,448,496,520,541,
0,1,40,77,109,137,159,227,264,290,319,347,381,419,457,495,526,
0,1,11,35,61,103,137,174,221,284,338,
0,1,9,30,67,104,145,171,234,267,354,402,461,
0,1,11,38,77,114,182,222,247,267,312,399,458,
0,1,11,34,67,97,126,202,238,274,335,405,438,473,507,537,562,
0,1,11,51,81,104,148,216,259,300,330,369,423,450,503,537,565,
0,1,17,42,78,134,
0,1,11,32,81,126,
0,1,11,37,65,100,139,165,234,304,342,372,616,657,686,720,751,
0,1,13,42,75,104,135,163,220,249,294,334,363,405,466,548,593,
0,1,15,42,73,120,153,181,292,323,362,391,422,451,618,650,673,
0,1,11,42,82,106,136,177,
0,1,8,45,99,159,209,238,278,374,401,433,462,501,529,554,
0,1,11,42,70,94,142,180,213,269,317,363,418,455,593,655,746,
0,1,11,41,96,136,
0,1,16,44,135,171,197,268,301,326,
0,1,9,46,76,114,157,185,216,255,292,338,440,541,585,618,659,
0,1,8,58,128,172,
0,1,13,48,
0,1,11,32,69,105,132,180,227,336,375,407,467,537,584,650,687,
0,1,12,46,75,115,150,181,206,246,319,
0,1,16,
0,1,12,38,77,127,193,231,267,304,331,361,397,424,450,501,532,
0,1,11,43,84,110,192,230,265,415,442,467,506,541,653,692,754,
0,1,14,41,91,121,166,291,333,363,390,428,460,493,526,567,590,
0,1,11,38,73,96,154,190,217,281,321,365,422,459,514,
0,1,17,45,66,99,195,237,297,345,
0,1,12,44,
0,1,15,40,74,116,150,194,227,254,324,355,406,517,644,815,875,
0,1,12,39,97,
0,1,21,51,81,170,208,
0,1,18,51,83,
0,1,10,44,82,118,144,178,222,248,294,321,375,407,437,483,525,
0,1,16,42,69,109,153,178,
0,1,13,41,68,105,139,186,262,310,335,365,393,429,463,514,548,
0,1,11,48,81,121,149,196,246,265,300,383,410,435,460,486,520,
0,1,11,43,80,134,173,214,318,346,380,484,
0,1,9,43,71,151,185,
0,1,14,46,78,116,144,229,262,294,319,347,400,422,456,517,538,
0,1,9,43,74,131,167,193,226,259,343,380,426,505,542,616,
0,1,14,50,88,133,170,206,259,288,325,358,422,456,498,
0,1,12,39,68,104,141,170,323,345,386,445,491,594,627,661,705,
0,1,12,70,100,135,174,212,242,343,447,505,592,707,742,779,824,
0,1,17,42,89,147,
0,1,11,49,79,142,173,213,246,295,361,386,437,519,551,636,707,
0,1,17,53,92,134,
0,1,11,46,101,126,153,198,226,254,290,346,431,474,536,604,639,
0,1,19,41,113,141,222,277,
0,1,15,49,84,120,144,182,228,261,
0,1,10,41,79,117,157,180,219,246,289,318,345,438,467,511,537,
0,1,25,55,
0,1,9,43,71,104,169,205,271,294,363,
0,1,14,45,88,121,160,200,266,296,336,370,
0,1,13,81,127,155,191,230,266,297,334,390,466,694,731,754,792,
0,1,15,48,75,107,147,184,
0,1,14,43,72,97,141,175,212,252,291,328,360,394,472,506,548,
0,1,11,62,100,162,201,228,259,291,322,353,388,426,458,486,535,
0,1,10,
0,1,9,42,71,126,184,249,276,310,363,398,423,451,485,535,569,
0,1,16,47,69,101,135,163,206,257,346,381,410,457,489,515,541,
0,1,15,44,88,133,167,
0,1,19,49,78,138,198,239,266,302,336,369,408,572,622,655,682,
0,1,15,49,73,123,179,210,268,296,333,385,408,449,504,586,653,
0,1,13,44,69,111,156,192,279,317,
