author:	Mlewandowska
date:	2019-09-08 23:48	2019-09-09 04:00
concentration = 0.15, size: 300x300
distribution: Gauss	scale: 1.0
init_number_X = 50, init_number_Y = 13500	n_links = 18
k1 = 1, k2 = 1, beta = 0, lambd = 0.7
number of simulations k = 10, number of iterations n = 1000
range sampling: [0, 5, 10, 20, 30, 40, 50, 60, 70, 80, 90, 100, 110, 120, 130, 140, 150]

0,1,8,28,50,69,97,124,139,145,177,201,221,221,221,221,221,
0,1,10,33,56,74,106,127,131,132,133,134,135,159,182,211,211,
0,1,8,29,51,52,53,54,55,56,57,58,59,60,110,110,110,
0,1,13,57,131,194,217,239,311,333,358,387,407,435,465,488,514,
0,1,10,32,52,75,77,78,79,80,81,82,83,84,85,108,113,
0,1,12,30,48,72,72,72,72,72,72,72,72,72,72,72,72,
0,1,7,33,54,58,59,60,61,62,63,135,135,135,135,135,135,
0,1,9,32,53,84,114,135,135,135,135,135,135,135,135,135,135,
0,1,12,28,55,80,103,124,138,138,138,138,138,138,138,138,138,
0,1,11,32,56,73,94,123,156,202,226,246,247,248,249,308,308,
0,1,10,29,49,72,92,93,94,94,94,94,94,94,94,94,94,
0,1,10,37,57,80,83,84,103,131,154,175,204,230,246,358,362,
0,1,15,37,64,85,107,131,191,219,244,275,296,323,348,374,421,
0,1,10,36,53,77,99,128,169,191,223,264,289,318,352,375,410,
0,1,11,32,80,104,123,143,149,149,149,149,149,149,149,149,149,
0,1,11,36,62,82,104,124,146,175,182,183,184,184,184,184,184,
0,1,9,42,66,102,111,112,113,114,115,116,117,126,155,186,212,
0,1,4,5,6,7,8,9,10,11,31,65,94,115,139,163,213,
0,1,8,14,15,16,17,18,19,20,21,22,23,27,28,29,63,
0,1,11,39,72,93,121,136,137,138,139,140,141,142,227,227,227,
0,1,10,26,27,28,29,30,31,32,166,166,166,166,166,166,166,
0,1,10,35,37,38,39,98,99,100,101,102,103,104,121,140,196,
0,1,9,28,52,83,106,133,153,181,200,233,251,261,261,261,261,
0,1,10,32,60,81,81,81,81,81,81,81,81,81,81,81,81,
0,1,9,29,54,78,82,82,82,82,82,82,82,82,82,82,82,
0,1,10,32,55,74,103,123,145,166,197,216,225,225,225,225,225,
0,1,7,23,49,84,108,130,131,167,167,167,167,167,167,167,167,
0,1,7,10,11,12,13,14,15,178,200,218,227,228,229,230,308,
0,1,10,38,65,94,107,108,109,110,111,112,113,114,135,234,249,
0,1,7,29,47,70,94,103,104,105,110,127,127,127,127,127,127,
0,1,10,33,53,75,103,104,104,104,104,104,104,104,104,104,104,
0,1,8,26,27,28,29,30,31,32,33,34,35,36,37,38,45,
0,1,8,30,53,54,55,56,57,58,59,60,61,163,195,222,254,
0,1,10,33,54,66,67,68,69,70,71,72,73,74,75,239,302,
0,1,12,35,60,87,109,119,119,119,119,119,119,119,119,119,119,
0,1,9,29,50,71,72,73,74,75,76,77,78,79,80,81,183,
0,1,8,35,57,80,108,126,127,128,129,130,131,132,133,135,135,
0,1,9,16,17,18,19,20,21,22,23,24,25,26,134,134,134,
0,1,9,36,55,73,100,123,184,204,227,246,275,300,346,372,396,
0,1,7,8,9,10,105,137,138,139,140,141,142,143,144,144,144,
0,1,9,33,43,44,45,117,140,152,153,154,155,156,157,255,255,
0,1,10,32,33,34,35,133,134,135,136,137,138,139,258,259,274,
0,1,9,33,53,74,86,87,88,89,90,91,92,112,133,133,133,
0,0,0,0,0,0,0,0,0,0,0,0,0,0,0,0,0,
0,1,8,33,60,85,107,107,107,107,107,107,107,107,107,107,107,
0,1,7,28,46,66,79,80,81,82,83,84,85,86,87,102,125,
0,1,9,24,48,76,98,113,114,115,116,117,189,210,224,246,253,
0,1,10,36,57,84,106,144,145,146,157,248,275,304,330,365,390,
0,1,10,33,54,71,92,93,94,95,196,258,258,258,258,258,258,
0,1,9,30,59,67,68,69,165,186,212,233,254,272,297,329,333,
0,1,9,30,55,84,113,139,140,141,142,143,144,173,204,204,204,
0,1,9,18,19,20,21,22,23,24,25,26,27,28,50,59,114,
0,1,2,3,4,5,6,7,8,9,10,11,12,13,14,26,59,
0,1,8,26,44,72,105,131,148,149,150,151,152,153,154,155,207,
0,1,8,31,58,80,107,120,120,120,120,120,120,120,120,120,120,
0,1,13,32,56,91,99,100,101,102,103,104,105,106,107,205,228,
0,1,8,35,56,83,104,117,129,130,131,132,247,264,265,267,276,
0,1,10,30,49,80,106,138,158,180,181,182,183,184,209,232,254,
0,1,10,39,61,81,81,81,81,81,81,81,81,81,81,81,81,
0,1,10,34,35,36,37,54,77,98,123,142,143,144,145,146,154,
0,1,9,38,61,83,109,132,133,164,181,181,181,181,181,181,181,
0,1,11,30,38,39,40,41,42,43,44,45,66,96,119,141,169,
0,1,7,39,72,89,111,185,206,231,253,274,293,327,337,337,337,
0,1,10,34,74,93,125,162,187,209,233,253,281,319,336,372,394,
0,1,9,29,52,78,101,122,142,165,194,213,242,263,264,275,298,
0,1,7,31,
0,1,8,28,58,81,111,139,160,188,217,228,228,228,228,228,228,
0,1,7,36,60,95,119,
0,1,9,29,46,72,89,115,137,158,194,212,238,264,265,266,282,
0,1,10,32,61,80,104,142,144,145,146,147,258,258,258,258,258,
0,1,11,33,57,58,59,60,61,62,63,67,115,137,158,176,176,
0,1,10,43,63,87,110,130,155,177,201,232,250,250,250,250,250,
0,1,10,27,51,77,99,102,102,102,102,102,102,102,102,102,102,
0,1,10,33,59,89,116,143,168,186,208,239,258,262,292,293,353,
0,1,11,34,53,70,100,121,149,196,210,211,212,287,288,315,346,
0,1,12,30,54,80,106,107,108,109,110,110,110,110,110,110,110,
0,1,13,32,60,93,119,123,124,125,126,127,129,147,162,163,268,
0,1,11,27,50,59,60,61,62,63,64,65,66,67,68,69,272,
0,1,8,29,57,81,103,123,124,125,126,131,137,138,139,140,184,
0,1,9,34,60,81,102,103,104,105,111,140,171,188,189,206,222,
0,1,7,37,58,79,103,125,144,145,146,147,148,149,150,151,153,
0,1,8,32,57,91,112,140,171,190,217,253,274,299,321,330,360,
0,1,5,11,56,81,110,138,163,184,221,245,247,248,249,250,272,
0,1,10,36,56,79,105,129,130,131,132,133,134,135,136,137,181,
0,1,8,26,50,73,94,117,117,117,117,117,117,117,117,117,117,
0,1,11,33,49,69,95,117,136,165,186,209,240,274,299,343,367,
0,1,11,30,54,78,97,119,127,127,127,127,127,127,127,127,127,
0,1,8,26,48,77,79,80,81,82,83,84,85,210,211,212,298,
0,1,9,30,53,79,81,82,83,84,85,86,87,88,89,112,137,
0,1,10,32,50,63,64,65,66,67,68,69,76,104,105,247,268,
0,1,9,25,26,27,28,29,30,31,32,33,34,35,36,53,75,
0,1,4,5,6,7,8,9,10,11,12,13,20,50,159,159,159,
0,1,8,30,46,69,70,71,72,73,74,75,76,77,78,79,80,
0,1,3,4,5,6,7,8,9,10,11,12,13,14,107,108,124,
0,1,10,36,59,79,110,129,153,179,274,297,
0,1,9,
0,1,8,32,53,73,88,89,90,91,92,93,94,141,230,251,251,
0,1,8,31,60,87,117,118,126,127,128,129,130,131,132,145,182,
0,1,8,36,47,47,47,47,47,47,47,47,47,47,47,47,47,
0,1,9,29,53,71,71,71,71,71,71,71,71,71,71,71,71,
0,1,8,29,55,79,104,124,131,132,133,134,142,204,266,266,266,
0,1,8,31,42,42,42,42,42,42,42,42,42,42,42,42,42,
0,1,11,31,57,77,99,119,123,124,125,126,127,128,129,166,166,
0,1,9,32,71,105,133,167,196,216,247,269,303,328,351,367,388,
0,1,9,28,51,73,84,85,111,111,111,111,111,111,111,111,111,
0,1,10,30,52,74,98,114,115,116,117,118,119,119,119,119,119,
0,1,9,34,53,75,94,127,153,175,186,186,186,186,186,186,186,
0,1,10,16,17,18,101,143,169,176,186,216,256,257,257,257,257,
0,1,8,29,50,75,79,80,81,82,83,84,85,86,95,128,141,
0,1,11,32,54,77,100,126,148,154,162,176,176,176,176,176,176,
0,1,10,31,32,33,34,35,36,37,38,39,40,41,42,43,358,
0,1,9,31,54,76,103,128,128,128,128,128,128,128,128,128,128,
0,1,9,31,62,87,108,115,135,162,195,207,208,209,210,228,291,
0,1,10,30,54,77,96,97,98,120,140,141,142,143,157,179,207,
0,1,8,29,50,70,86,92,93,94,95,96,110,135,154,154,154,
0,1,7,32,55,78,80,80,80,80,80,80,80,80,80,80,80,
0,1,9,30,56,80,103,104,105,106,124,145,162,194,227,252,289,
0,1,8,36,56,79,108,108,108,108,108,108,108,108,108,108,108,
0,1,8,25,45,63,89,89,89,89,89,89,89,89,89,89,89,
0,1,9,33,52,53,54,55,56,57,58,59,60,61,73,102,134,
0,1,7,32,32,32,32,32,32,32,32,32,32,32,32,32,32,
0,1,11,28,48,78,107,130,164,183,206,211,212,213,214,215,231,
0,1,11,35,52,72,121,127,128,129,130,131,243,266,292,302,302,
0,1,9,29,51,57,57,57,57,57,57,57,57,57,57,57,57,
0,1,8,25,59,81,156,178,203,229,258,278,304,312,313,337,356,
0,1,8,20,21,22,23,24,25,26,27,28,29,30,31,32,328,
0,1,11,29,56,78,108,138,143,144,196,217,261,278,278,278,278,
0,1,10,34,55,78,108,129,148,177,200,225,241,242,243,245,245,
0,1,10,39,59,89,108,132,159,179,212,247,263,277,277,277,277,
0,1,9,29,55,56,57,58,59,59,59,59,59,59,59,59,59,
0,1,11,34,57,78,96,96,96,96,96,96,96,96,96,96,96,
0,1,8,28,59,77,102,125,151,171,193,229,251,278,294,294,294,
0,1,9,27,52,53,54,55,56,57,58,59,60,61,62,63,65,
0,1,10,30,54,75,76,77,78,79,80,81,82,83,210,210,210,
0,1,10,31,51,78,100,125,126,127,133,239,273,296,316,336,359,
0,1,13,34,57,80,106,128,180,181,182,183,184,185,186,187,200,
0,1,2,3,4,5,6,7,8,9,10,11,12,13,19,20,36,
0,1,9,29,49,69,97,123,151,182,184,185,186,187,188,299,301,
0,1,11,33,61,81,105,126,127,128,129,130,131,132,133,141,141,
0,1,10,29,64,94,95,96,97,98,99,100,101,102,103,116,147,
0,1,7,29,48,66,92,130,150,174,180,197,198,199,200,201,222,
0,1,7,30,46,70,95,96,97,98,99,100,101,102,103,113,166,
0,1,7,32,44,45,46,47,48,49,50,51,52,53,54,55,300,
0,1,11,38,63,88,113,118,119,120,121,122,170,170,170,170,170,
0,1,9,10,10,10,10,10,10,10,10,10,10,10,10,10,10,
0,1,8,29,51,70,99,119,120,120,120,120,120,120,120,120,120,
0,1,10,18,19,20,21,22,23,24,25,26,125,127,133,133,133,
0,1,8,9,10,11,12,13,14,15,16,17,18,288,295,295,295,
0,1,9,27,50,73,94,110,143,164,192,222,242,245,245,245,245,
0,1,11,19,20,21,22,23,24,25,26,27,28,29,30,86,86,
0,1,11,27,50,74,109,110,111,112,113,114,115,116,117,179,179,
0,1,8,30,62,107,152,188,212,233,256,283,291,291,291,291,291,
0,1,10,39,69,96,117,122,123,124,125,132,132,132,132,132,132,
0,1,8,35,63,81,85,86,87,88,89,90,91,92,93,94,130,
0,1,10,33,50,51,52,53,54,55,56,57,58,59,60,60,60,
0,1,10,34,53,94,115,138,164,171,172,173,174,175,176,356,398,
0,1,7,25,48,72,94,105,113,140,188,213,235,269,300,306,306,
0,1,8,31,55,70,71,72,73,74,75,76,77,78,79,134,134,
0,1,10,33,57,75,76,77,78,79,80,81,82,83,85,230,239,
0,1,10,36,67,88,106,144,155,155,155,155,155,155,155,155,155,
0,1,12,51,82,106,126,154,180,191,192,193,194,195,196,261,283,
0,1,10,30,53,75,94,98,99,100,101,102,103,104,105,106,356,
0,1,10,34,58,80,103,133,175,206,230,259,287,297,298,311,345,
0,1,9,27,49,50,51,52,53,54,55,56,57,78,78,78,78,
0,1,10,32,62,84,105,140,141,142,143,144,145,299,303,303,303,
0,1,7,36,54,84,110,131,139,139,139,139,139,139,139,139,139,
0,1,10,32,54,73,99,100,101,102,103,104,105,106,107,108,150,
0,1,6,35,39,40,41,42,43,77,78,79,80,81,90,113,138,
0,1,7,32,53,75,91,117,128,128,128,128,128,128,128,128,128,
0,1,11,31,56,57,58,59,60,61,62,88,115,152,184,201,226,
0,1,8,21,22,23,24,25,26,27,167,167,167,167,167,167,167,
0,1,9,31,51,69,70,71,72,73,74,75,76,77,232,232,232,
0,1,8,28,47,69,90,127,155,172,172,172,172,172,172,172,172,
0,1,7,32,53,81,101,120,147,155,156,157,158,159,237,238,255,
0,1,8,28,55,82,94,95,96,97,98,102,103,104,105,106,187,
0,1,11,39,51,51,51,51,51,51,51,51,51,51,51,51,51,
0,1,9,27,46,47,48,49,50,51,52,53,54,55,56,134,293,
0,1,9,35,60,64,65,66,67,68,69,70,71,324,345,365,386,
0,1,10,30,51,70,104,129,149,166,183,183,183,183,183,183,183,
0,1,10,28,52,76,101,130,142,143,144,145,146,147,148,149,211,
0,1,12,30,57,78,102,122,136,136,136,136,136,136,136,136,136,
0,1,13,35,57,77,105,140,158,176,194,194,194,194,194,194,194,
0,1,8,26,45,70,91,107,107,107,107,107,107,107,107,107,107,
0,1,8,32,62,95,120,130,131,132,133,134,135,280,304,322,349,
0,1,11,30,50,85,107,126,131,132,133,134,154,179,193,194,268,
0,1,9,28,53,72,103,137,161,182,185,185,185,185,185,185,185,
0,1,9,28,49,75,91,92,93,94,95,96,97,98,116,137,147,
0,1,10,32,53,74,105,119,119,119,119,119,119,119,119,119,119,
0,1,10,12,13,14,15,16,17,29,30,31,32,33,42,87,103,
0,1,11,33,59,89,101,102,103,104,105,106,107,108,123,150,190,
0,1,11,37,110,162,185,204,227,281,297,315,353,393,406,407,465,
0,1,9,32,52,78,108,130,153,154,155,156,157,158,158,158,158,
0,1,10,39,60,83,141,166,185,211,217,218,219,220,221,222,226,
0,1,8,30,57,79,116,136,159,160,160,160,160,160,160,160,160,
0,1,9,34,50,72,104,120,121,122,123,124,125,126,127,128,139,
0,1,10,32,52,79,104,132,155,173,174,232,279,297,297,297,297,
0,1,9,29,42,42,42,42,42,42,42,42,42,42,42,42,42,
0,1,13,37,67,91,92,93,94,95,96,97,98,106,106,106,106,
0,1,11,33,51,75,89,90,91,92,107,108,109,110,111,112,119,
0,1,8,31,53,71,88,89,90,91,92,93,94,95,96,106,155,
0,1,9,36,55,79,95,96,97,98,99,100,101,102,103,107,130,
0,1,9,33,52,71,99,113,146,170,170,170,170,170,170,170,170,
0,1,9,29,48,72,106,131,143,145,169,194,225,235,247,247,247,
0,1,13,30,53,93,118,148,171,195,196,214,249,250,250,250,250,
0,1,10,32,52,88,89,90,91,92,98,136,150,151,152,153,242,
0,1,9,31,57,81,100,150,183,211,231,255,272,302,331,349,373,
0,1,7,27,57,80,113,131,132,133,134,135,136,160,188,210,223,
0,1,9,33,54,86,106,129,157,179,202,210,210,210,210,210,210,
0,1,9,35,61,80,111,133,151,170,225,240,241,242,263,281,300,
0,1,7,31,62,117,141,157,204,227,242,269,292,293,293,293,293,
0,1,8,30,51,66,66,66,66,66,66,66,66,66,66,66,66,
0,1,12,33,56,57,58,59,60,61,62,63,64,283,303,303,303,
0,1,11,29,33,34,35,36,37,38,39,40,50,70,94,119,132,
0,1,10,33,54,60,61,62,63,64,65,66,67,68,69,70,119,
0,1,9,28,44,45,53,68,69,70,71,72,73,86,118,118,118,
0,1,11,37,77,137,171,201,226,246,263,264,265,266,267,277,445,
0,1,9,39,60,82,102,133,136,137,138,139,140,150,151,200,222,
0,1,7,30,49,70,93,123,152,176,201,228,270,286,286,286,286,
0,1,12,26,27,28,29,30,31,32,33,34,35,36,37,38,72,
0,1,11,38,59,81,104,124,177,199,217,240,241,242,243,320,321,
0,1,6,26,49,71,92,112,131,142,143,147,154,155,156,172,191,
0,1,9,28,57,78,88,88,88,88,88,88,88,88,88,88,88,
0,1,9,34,57,86,120,149,174,195,196,197,198,199,200,245,245,
0,1,9,29,50,74,98,120,121,139,162,163,164,165,166,167,234,
0,1,9,29,52,79,103,127,134,135,136,189,190,191,210,221,221,
0,1,10,30,54,82,103,126,159,168,168,168,168,168,168,168,168,
0,1,10,32,52,77,92,124,125,126,127,128,256,286,303,323,377,
0,1,10,29,61,83,104,130,150,176,203,224,252,277,316,340,363,
0,1,9,29,49,75,94,116,145,169,181,182,183,184,185,215,248,
0,1,9,33,43,44,45,46,47,48,49,50,51,346,346,346,346,
0,1,9,26,50,72,95,117,139,150,150,150,150,150,150,150,150,
0,1,9,30,51,52,53,54,55,56,57,58,59,60,61,62,191,
0,1,10,25,49,84,96,97,98,99,100,101,121,128,128,128,128,
0,1,10,35,58,76,116,132,147,148,149,150,151,152,153,257,257,
0,1,10,28,52,72,102,123,142,143,144,162,189,192,195,218,294,
0,1,9,31,54,55,56,57,58,59,60,61,62,63,64,65,127,
0,1,11,31,56,86,116,141,161,180,182,183,219,220,221,244,248,
0,1,8,25,46,66,100,113,114,115,116,117,118,119,120,121,144,
0,1,10,36,56,74,94,115,116,117,118,126,146,146,146,146,146,
0,1,8,29,52,89,118,142,162,177,177,177,177,177,177,177,177,
0,1,11,39,60,61,62,63,64,65,66,67,68,69,70,71,357,
0,1,8,29,49,70,94,117,135,135,135,135,135,135,135,135,135,
0,1,8,31,54,73,97,119,142,165,166,167,168,169,170,171,301,
0,1,9,35,58,75,76,77,78,79,80,86,102,143,145,145,145,
0,1,9,26,46,63,64,65,66,67,68,69,81,96,97,107,162,
0,1,9,31,48,68,68,68,68,68,68,68,68,68,68,68,68,
0,1,7,37,78,86,86,86,86,86,86,86,86,86,86,86,86,
0,1,10,28,49,49,49,49,49,49,49,49,49,49,49,49,49,
0,1,11,32,60,87,114,136,185,216,239,278,304,330,364,388,412,
0,1,11,35,62,87,115,140,165,200,226,249,270,292,314,336,357,
0,1,9,38,43,67,97,120,145,145,145,145,145,145,145,145,145,
0,1,10,30,50,72,91,113,143,164,185,186,186,186,186,186,186,
0,1,11,37,55,60,61,62,63,64,77,77,77,77,77,77,77,
0,1,9,33,53,75,91,120,133,133,133,133,133,133,133,133,133,
0,1,9,33,65,85,110,138,160,184,201,223,237,237,237,237,237,
0,1,10,31,56,77,98,120,137,138,139,140,141,142,160,189,189,
0,1,10,30,59,81,92,93,94,95,96,97,98,99,234,235,265,
0,1,9,34,68,91,95,96,97,98,99,100,101,102,103,104,375,
0,1,7,28,52,56,57,58,81,101,101,101,101,101,101,101,101,
0,1,9,32,51,90,139,140,141,145,170,198,217,236,263,282,310,
0,1,11,35,50,51,52,53,54,55,56,57,58,59,60,144,144,
0,1,8,30,57,82,102,129,157,195,212,213,214,215,216,217,301,
0,1,12,37,65,66,67,68,69,70,71,72,73,82,113,131,159,
0,1,10,29,54,81,106,133,152,193,202,203,204,205,267,288,297,
0,1,9,26,44,58,59,60,61,62,63,64,65,66,67,169,169,
0,1,8,27,39,39,39,39,39,39,39,39,39,39,39,39,39,
0,1,8,30,61,71,72,73,91,108,109,110,111,228,254,275,289,
0,1,8,32,62,86,109,135,164,188,216,229,230,260,284,302,332,
0,1,10,30,52,74,94,119,136,137,138,139,140,141,142,154,184,
0,1,10,32,43,44,45,46,47,48,49,50,67,78,111,134,139,
0,1,10,29,54,76,108,127,146,148,149,150,151,152,160,162,214,
0,1,10,33,59,82,88,89,155,159,160,161,162,163,164,165,243,
0,0,0,0,0,0,0,0,0,0,0,0,0,0,0,0,0,
0,1,7,30,57,85,115,131,138,139,140,141,142,143,144,167,206,
0,1,11,32,60,81,104,114,115,129,149,150,150,150,150,150,150,
0,1,10,28,48,71,90,135,158,185,196,196,196,196,196,196,196,
0,1,9,30,51,73,73,73,73,73,73,73,73,73,73,73,73,
0,1,9,29,52,67,68,69,70,71,72,75,95,114,136,160,199,
0,1,8,29,50,82,110,126,147,150,151,152,175,215,258,275,304,
0,1,5,25,45,45,45,45,45,45,45,45,45,45,45,45,45,
0,1,9,32,55,72,96,117,118,119,120,121,122,123,124,125,147,
0,1,13,58,
0,1,12,35,57,68,69,70,71,72,73,74,75,76,77,78,82,
0,1,10,38,61,62,63,64,65,66,67,68,69,108,108,108,108,
0,1,9,31,56,79,100,120,121,122,147,147,147,147,147,147,147,
0,1,10,32,43,44,45,46,47,48,49,50,57,120,165,184,197,
0,1,9,32,40,41,42,43,44,45,46,47,48,49,67,88,116,
0,1,8,26,46,71,94,135,157,181,200,200,200,200,200,200,200,
0,1,2,3,4,5,6,7,8,9,10,11,12,305,327,348,375,
0,1,10,25,26,27,28,29,30,31,32,33,34,35,36,86,327,
0,1,5,25,45,63,81,91,91,91,91,91,91,91,91,91,91,
0,1,11,33,52,78,96,127,147,174,175,176,177,178,179,180,200,
0,1,9,29,47,60,61,62,63,64,65,66,67,68,69,70,134,
0,1,2,3,4,5,6,7,8,59,60,61,62,63,64,72,104,
0,1,11,29,49,50,51,52,53,54,55,56,57,58,59,60,64,
0,1,9,36,58,70,70,70,70,70,70,70,70,70,70,70,70,
0,1,10,31,49,50,51,68,89,123,143,151,152,153,154,155,194,
0,1,6,24,36,37,38,39,40,41,42,68,96,116,131,131,131,
0,1,10,37,70,93,120,155,175,175,175,175,175,175,175,175,175,
0,1,9,26,50,69,70,71,72,73,74,75,76,77,88,102,123,
0,1,8,34,42,43,44,45,46,47,48,49,50,51,52,53,142,
0,1,9,30,53,81,105,108,109,110,111,112,113,118,171,193,193,
0,1,8,30,43,43,43,43,43,43,43,43,43,43,43,43,43,
0,1,10,11,12,24,27,28,29,30,31,32,33,34,35,91,91,
0,1,9,31,46,47,48,49,50,51,52,53,54,55,56,57,68,
0,1,9,31,53,76,95,125,145,173,200,245,282,302,324,329,329,
0,1,8,34,54,75,76,77,78,79,80,81,82,83,83,83,83,
0,1,9,34,55,81,106,125,138,139,140,141,142,143,144,299,299,
0,1,8,30,33,34,35,36,37,38,39,40,41,42,43,45,62,
0,1,10,31,51,66,90,110,133,134,135,136,137,149,173,195,219,
0,1,10,37,63,83,107,130,150,151,152,153,154,155,156,157,186,
0,1,8,14,15,16,17,18,42,78,79,80,81,82,83,223,223,
0,1,5,6,7,8,9,10,11,12,13,14,15,16,17,161,161,
0,1,9,34,57,75,104,128,131,132,133,134,142,160,184,203,227,
0,1,15,33,60,77,96,129,158,201,220,221,222,295,311,311,311,
0,1,10,30,54,74,95,101,102,103,104,105,106,107,151,151,151,
0,1,11,31,47,53,54,55,56,57,58,59,84,105,140,156,194,
0,1,9,34,55,93,117,144,182,204,225,266,285,306,326,369,388,
0,1,11,33,53,75,91,114,136,164,193,220,241,271,314,343,376,
0,1,9,37,55,87,101,101,101,101,101,101,101,101,101,101,101,
0,1,11,29,55,81,112,129,154,179,180,181,182,183,200,235,265,
0,1,10,32,62,80,98,124,144,165,183,194,195,196,197,294,294,
0,1,10,34,59,82,104,118,119,120,121,122,123,132,159,192,217,
0,1,8,32,64,92,109,110,111,112,113,114,294,316,336,346,346,
0,1,9,32,55,56,57,58,59,60,61,62,63,64,65,96,158,
0,1,9,32,64,79,80,81,82,83,84,85,86,156,157,196,219,
0,1,10,31,56,73,91,109,134,169,197,203,203,203,203,203,203,
0,1,11,33,56,82,103,128,169,210,217,217,217,217,217,217,217,
0,1,11,33,54,75,75,75,75,75,75,75,75,75,75,75,75,
0,1,10,27,49,80,101,120,148,149,150,151,152,163,163,163,163,
0,1,9,33,65,100,125,152,181,201,226,254,286,306,324,324,324,
0,1,7,30,48,74,82,82,82,82,82,82,82,82,82,82,82,
0,1,2,3,4,5,6,7,8,9,10,11,12,20,42,83,123,
0,1,10,27,51,51,51,51,51,51,51,51,51,51,51,51,51,
0,1,12,34,54,79,102,125,148,168,190,214,233,254,274,299,337,
0,1,9,26,50,80,102,120,144,168,176,177,178,179,180,181,186,
0,1,10,29,33,34,35,36,37,38,39,46,47,48,308,339,363,
0,1,10,37,57,76,86,87,88,89,90,91,92,93,94,124,130,
0,1,7,28,31,32,33,34,35,36,37,53,70,96,118,146,166,
0,1,9,38,60,82,99,125,148,149,149,149,149,149,149,149,149,
