author:	Mlewandowska
date:	2019-09-07 23:05	2019-09-08 00:03
concentration = 0.15, size: 300x300
distribution: Gauss	scale: 1.0
init_number_X = 50, init_number_Y = 13500	n_links = 45
k1 = 1, k2 = 1, beta = 0, lambd = 1.0
number of simulations k = 10, number of iterations n = 1000
range sampling: [0, 5, 10, 20, 30, 40, 50, 60, 70, 80, 90, 100, 110, 120, 130, 140, 150]

0,1,3,4,5,6,7,8,9,10,11,12,13,14,15,16,93,
0,1,7,22,40,56,66,67,68,69,70,71,72,73,73,73,73,
0,1,8,24,32,33,34,35,36,39,45,45,45,45,45,45,45,
0,1,2,3,4,5,6,7,8,21,26,27,28,30,30,30,30,
0,1,7,25,41,41,41,41,41,41,41,41,41,41,41,41,41,
0,1,7,23,37,50,54,55,56,65,66,67,77,77,77,77,77,
0,1,6,22,24,24,24,24,24,24,24,24,24,24,24,24,24,
0,1,6,22,30,31,49,67,70,71,72,73,74,75,76,102,118,
0,1,8,25,38,39,40,41,42,43,44,51,53,54,55,73,80,
0,1,6,25,40,56,70,70,70,70,70,70,70,70,70,70,70,
0,1,4,5,6,7,8,9,10,11,75,75,75,75,75,75,75,
0,1,6,20,37,45,46,47,48,49,50,51,52,53,53,53,53,
0,1,7,25,26,27,28,29,30,31,32,33,57,58,64,75,75,
0,1,7,10,11,12,13,14,15,16,17,18,19,20,21,22,28,
0,1,7,19,37,38,39,40,41,42,43,44,45,54,65,70,70,
0,1,7,19,35,43,44,44,44,44,44,44,44,44,44,44,44,
0,1,8,17,18,19,20,21,22,23,24,37,37,37,37,37,37,
0,1,6,22,38,54,59,68,85,96,97,98,98,98,98,98,98,
0,1,6,23,36,37,38,39,40,41,42,43,44,45,46,47,91,
0,1,7,17,18,19,20,21,58,58,58,58,58,58,58,58,58,
0,1,7,22,24,25,46,49,50,51,52,65,71,71,71,71,71,
0,1,7,20,43,56,58,59,60,61,62,63,82,83,84,88,89,
0,1,7,19,20,21,22,23,24,25,26,27,28,54,54,54,54,
0,1,2,3,4,5,6,7,8,9,10,11,14,30,50,51,70,
0,1,8,13,14,15,15,15,15,15,15,15,15,15,15,15,15,
0,1,7,11,12,13,14,15,16,17,18,19,20,21,22,23,96,
0,1,6,26,39,45,46,47,48,48,48,48,48,48,48,48,48,
0,1,8,22,27,28,29,30,49,56,57,58,59,61,62,63,76,
0,1,6,21,36,48,55,55,55,55,55,55,55,55,55,55,55,
0,1,6,23,38,55,60,60,60,60,60,60,60,60,60,60,60,
0,1,7,22,38,42,43,44,45,46,47,48,49,50,51,52,62,
0,1,7,19,20,21,22,23,24,25,26,27,28,29,50,50,50,
0,1,7,20,34,49,62,63,64,65,66,67,68,69,74,84,84,
0,1,7,22,25,26,27,28,29,30,31,32,33,34,46,46,46,
0,1,8,21,40,49,49,49,49,49,49,49,49,49,49,49,49,
0,1,7,22,27,28,29,30,31,32,33,34,35,38,53,57,57,
0,1,2,3,4,5,6,7,8,9,10,11,12,13,14,25,25,
0,1,4,5,6,7,8,9,10,11,42,42,42,42,42,42,42,
0,1,7,25,38,53,65,65,65,65,65,65,65,65,65,65,65,
0,1,3,4,5,6,7,8,26,28,46,47,48,49,50,55,71,
0,1,7,19,20,21,22,23,24,25,26,30,31,32,41,57,61,
0,1,7,24,38,53,56,58,58,58,58,58,58,58,58,58,58,
0,1,8,23,35,35,35,35,35,35,35,35,35,35,35,35,35,
0,1,6,10,10,10,10,10,10,10,10,10,10,10,10,10,10,
0,1,7,23,37,46,47,48,49,50,51,52,53,62,62,62,62,
0,1,2,3,4,5,6,7,8,8,8,8,8,8,8,8,8,
0,1,7,22,40,47,48,49,50,51,52,53,54,55,56,57,64,
0,1,6,22,35,36,36,36,36,36,36,36,36,36,36,36,36,
0,1,7,11,11,11,11,11,11,11,11,11,11,11,11,11,11,
0,1,6,21,34,36,36,36,36,36,36,36,36,36,36,36,36,
0,1,7,14,14,14,14,14,14,14,14,14,14,14,14,14,14,
0,1,8,23,40,46,46,46,46,46,46,46,46,46,46,46,46,
0,1,7,20,23,24,25,26,27,28,29,30,31,32,33,34,50,
0,1,8,24,38,44,45,59,60,71,72,73,74,75,76,77,94,
0,1,6,11,11,11,11,11,11,11,11,11,11,11,11,11,11,
0,1,7,23,23,23,23,23,23,23,23,23,23,23,23,23,23,
0,1,6,20,35,39,40,41,42,43,44,45,46,47,48,91,91,
0,1,6,19,19,19,19,19,19,19,19,19,19,19,19,19,19,
0,1,2,3,4,5,6,7,8,9,10,11,19,20,36,44,44,
0,1,8,18,18,18,18,18,18,18,18,18,18,18,18,18,18,
0,1,4,5,6,7,8,9,10,35,43,45,54,55,94,94,94,
0,1,5,23,27,28,29,30,31,32,33,34,35,36,37,38,44,
0,1,7,20,36,51,58,59,60,61,62,67,67,67,67,67,67,
0,1,7,21,37,40,41,42,43,44,45,46,47,48,49,50,76,
0,0,0,0,0,0,0,0,0,0,0,0,0,0,0,0,0,
0,1,7,8,9,10,11,12,13,14,15,16,17,18,18,18,18,
0,1,8,26,41,43,43,43,43,43,43,43,43,43,43,43,43,
0,1,7,24,25,26,27,28,29,30,31,32,33,51,67,70,70,
0,1,6,22,31,32,33,34,35,36,37,38,39,40,41,42,69,
0,1,7,8,9,10,11,12,13,14,15,16,29,29,29,29,29,
0,1,7,21,41,58,59,60,61,62,63,64,68,79,80,81,90,
0,1,7,21,34,35,36,37,38,39,40,41,42,43,44,45,50,
0,1,7,25,37,49,60,61,62,63,64,64,64,64,64,64,64,
0,1,7,20,21,22,23,24,25,26,27,28,29,30,31,32,37,
0,1,7,22,29,30,31,32,33,34,35,36,37,38,39,40,48,
0,1,7,22,39,51,53,54,55,56,57,58,59,60,61,62,68,
0,1,7,13,13,13,13,13,13,13,13,13,13,13,13,13,13,
0,1,7,23,28,29,30,31,32,34,53,69,69,69,69,69,69,
0,1,8,25,26,27,28,29,30,31,32,33,34,35,45,62,81,
0,1,7,21,37,45,46,47,48,49,50,51,52,53,54,62,74,
0,1,8,23,24,25,26,27,28,29,30,31,32,33,75,75,75,
0,1,7,20,36,39,39,39,39,39,39,39,39,39,39,39,39,
0,1,6,21,35,51,52,56,56,56,56,56,56,56,56,56,56,
0,1,7,25,34,35,36,37,38,39,53,53,53,53,53,53,53,
0,1,5,22,40,54,55,56,57,65,67,68,69,70,71,86,94,
0,1,5,6,7,8,9,10,11,12,13,14,15,19,19,19,19,
0,1,7,20,34,35,36,51,52,53,54,55,58,68,83,94,94,
0,1,2,3,4,5,6,7,8,9,10,11,12,27,42,59,76,
0,1,6,14,15,16,17,18,19,20,25,26,27,28,38,39,50,
0,1,9,22,32,33,34,35,36,36,36,36,36,36,36,36,36,
0,1,6,9,10,11,12,13,14,15,16,17,61,69,69,69,69,
0,1,5,22,37,45,46,47,48,49,50,51,52,53,54,55,71,
0,1,7,22,39,52,70,85,87,88,89,90,91,92,93,94,94,
0,1,7,11,12,13,14,15,36,60,61,68,69,69,69,69,69,
0,1,7,21,35,38,39,40,41,42,43,80,95,103,104,105,120,
0,1,3,4,5,6,7,8,9,10,11,12,13,14,17,33,44,
0,1,7,24,39,52,54,55,56,57,58,59,60,65,83,87,87,
0,1,8,24,28,29,30,31,32,33,34,35,36,37,38,39,41,
0,1,6,21,35,42,43,44,45,46,47,48,52,88,89,89,89,
0,1,8,23,37,51,51,51,51,51,51,51,51,51,51,51,51,
0,1,2,3,4,5,6,7,8,9,10,11,12,18,37,54,68,
0,1,6,11,12,13,14,15,16,17,18,19,20,21,34,45,45,
0,1,7,23,34,34,34,34,34,34,34,34,34,34,34,34,34,
0,1,6,22,38,50,51,52,53,54,70,71,71,71,71,71,71,
0,1,7,23,39,52,67,69,70,79,80,81,82,83,84,85,116,
0,1,6,20,38,51,52,53,54,55,56,57,58,59,60,61,77,
0,1,6,10,11,12,13,14,15,16,17,18,19,20,21,21,21,
0,1,7,22,28,29,30,31,32,33,34,35,36,37,38,39,54,
0,1,6,21,24,24,24,24,24,24,24,24,24,24,24,24,24,
0,1,7,21,37,38,39,40,41,42,43,44,53,56,57,67,86,
0,1,7,24,26,27,28,29,86,86,86,86,86,86,86,86,86,
0,1,6,15,16,17,18,19,20,21,22,23,24,24,24,24,24,
0,1,8,23,38,56,57,58,59,60,61,62,63,69,69,69,69,
0,1,7,22,24,25,26,27,28,29,30,31,31,31,31,31,31,
0,1,7,8,9,10,11,12,13,14,15,36,50,67,84,86,86,
0,1,7,21,22,23,24,25,26,27,28,29,30,31,32,33,41,
0,1,7,12,13,14,15,16,17,18,19,20,21,30,43,43,43,
0,1,8,22,36,43,44,45,46,47,48,49,50,51,52,115,115,
0,1,7,23,39,41,42,43,44,45,46,47,55,55,55,55,55,
0,1,7,22,37,37,37,37,37,37,37,37,37,37,37,37,37,
0,1,2,3,4,5,6,7,8,9,10,11,12,13,14,15,22,
0,1,7,21,29,29,29,29,29,29,29,29,29,29,29,29,29,
0,1,7,13,14,15,16,17,18,26,35,36,37,38,39,47,62,
0,1,7,22,39,55,72,73,74,75,75,75,75,75,75,75,75,
0,1,5,13,13,13,13,13,13,13,13,13,13,13,13,13,13,
0,1,6,21,24,25,26,27,56,56,56,56,56,56,56,56,56,
0,1,7,21,25,26,27,28,29,30,31,32,33,34,35,36,40,
0,1,8,25,35,36,37,38,39,40,41,42,43,53,68,81,96,
0,1,8,26,32,33,34,35,36,37,38,39,40,41,41,41,41,
0,1,7,23,38,49,50,51,52,53,54,55,56,57,58,62,75,
0,1,7,22,35,50,51,52,53,53,53,53,53,53,53,53,53,
0,1,7,22,38,40,41,42,43,44,45,46,47,57,70,87,106,
0,1,7,22,39,50,54,60,61,62,63,64,70,70,70,70,70,
0,1,2,3,4,5,6,7,8,9,10,11,17,33,47,49,49,
0,1,7,16,17,18,19,20,21,22,29,44,54,55,56,57,59,
0,1,7,19,20,21,22,23,24,25,26,27,35,38,38,38,38,
0,1,7,16,16,16,16,16,16,16,16,16,16,16,16,16,16,
0,1,7,21,36,44,45,46,47,48,49,50,51,52,53,63,63,
0,1,3,4,5,6,7,8,9,24,25,26,27,33,33,33,33,
0,1,3,4,5,6,7,8,9,10,11,12,12,12,12,12,12,
0,1,8,25,44,60,69,70,71,72,73,76,94,95,96,108,114,
0,1,7,23,35,50,66,70,71,72,73,74,75,76,77,83,86,
0,1,8,23,24,25,26,27,28,29,30,31,38,57,57,57,57,
0,1,7,22,30,31,32,33,34,34,34,34,34,34,34,34,34,
0,1,6,21,41,42,43,44,45,46,47,53,53,53,53,53,53,
0,1,5,25,36,37,38,39,40,41,42,43,55,56,57,71,71,
0,1,4,4,4,4,4,4,4,4,4,4,4,4,4,4,4,
0,1,9,11,11,11,11,11,11,11,11,11,11,11,11,11,11,
0,1,6,14,15,16,17,18,19,20,21,22,23,24,31,31,31,
0,1,7,20,34,54,56,57,57,57,57,57,57,57,57,57,57,
0,1,7,25,40,40,40,40,40,40,40,40,40,40,40,40,40,
0,1,2,3,4,5,6,29,30,31,32,33,34,38,58,68,69,
0,1,7,18,36,37,38,39,40,41,42,43,47,60,60,60,60,
0,1,7,23,38,40,41,42,43,44,45,46,47,48,49,54,54,
0,1,2,3,4,11,28,31,32,33,46,49,49,49,49,49,49,
0,1,7,20,21,22,23,24,25,38,39,40,41,42,43,45,64,
0,1,6,22,37,47,48,49,50,51,52,53,54,55,86,87,96,
0,1,7,25,41,52,52,52,52,52,52,52,52,52,52,52,52,
0,1,7,21,22,23,24,25,26,27,28,29,34,54,55,56,66,
0,1,6,21,34,34,34,34,34,34,34,34,34,34,34,34,34,
0,1,6,23,36,37,38,49,55,56,57,58,59,60,61,124,133,
0,1,7,24,31,32,33,34,35,36,37,38,39,40,45,63,78,
0,1,8,16,16,16,16,16,16,16,16,16,16,16,16,16,16,
0,1,7,21,41,42,43,44,45,46,47,48,49,50,51,52,72,
0,1,7,21,34,36,37,38,64,64,64,64,64,64,64,64,64,
0,1,8,22,23,24,25,26,27,28,29,30,31,56,73,76,92,
0,1,7,14,15,16,17,18,18,18,18,18,18,18,18,18,18,
0,1,2,3,4,28,29,68,68,68,68,68,68,68,68,68,68,
0,1,6,20,37,51,61,62,63,67,68,69,70,79,79,79,79,
0,1,7,22,37,46,47,48,49,50,51,52,53,57,73,86,86,
0,1,2,3,4,5,6,11,31,52,59,60,61,62,63,64,68,
0,1,1,1,1,1,1,1,1,1,1,1,1,1,1,1,1,
0,1,7,23,33,33,33,33,33,33,33,33,33,33,33,33,33,
0,1,7,15,16,17,18,19,20,21,22,30,31,32,33,34,45,
0,1,7,24,39,46,47,48,49,51,52,53,54,55,76,76,76,
0,1,7,22,39,42,43,44,45,46,47,48,49,50,51,52,109,
0,1,7,21,35,36,37,38,39,40,41,42,43,45,63,78,91,
0,1,6,21,35,52,53,54,55,56,57,58,59,70,79,79,79,
0,1,5,15,16,17,18,19,20,21,22,23,36,37,38,39,49,
0,1,6,21,39,49,50,51,52,53,54,55,56,57,61,61,61,
0,1,8,22,36,56,68,68,68,68,68,68,68,68,68,68,68,
0,1,6,16,17,18,19,20,21,26,27,28,29,30,31,32,34,
0,1,7,10,11,12,13,14,15,16,27,28,29,30,31,32,44,
0,1,7,10,11,12,13,14,15,16,22,23,24,25,26,27,50,
0,1,7,9,10,11,12,13,14,15,16,18,18,18,18,18,18,
0,1,5,6,7,8,9,10,64,65,66,67,68,69,70,71,82,
0,1,7,28,29,30,31,32,33,34,35,36,37,38,39,48,64,
0,1,6,25,41,58,63,64,65,66,67,68,69,70,71,72,110,
0,1,7,24,37,44,45,46,47,48,49,50,51,52,101,102,135,
0,1,7,20,35,37,38,39,40,41,42,43,89,89,89,89,89,
0,1,6,20,34,53,70,79,80,81,82,83,84,85,86,87,107,
0,1,8,23,37,41,42,43,44,45,46,73,74,75,76,84,84,
0,1,6,21,36,49,60,61,62,63,64,65,103,104,105,115,133,
0,1,7,23,32,33,34,35,36,37,38,39,40,44,45,46,48,
0,1,7,15,16,17,18,19,27,28,29,30,31,32,33,35,51,
0,1,7,23,38,44,45,46,50,57,57,57,57,57,57,57,57,
0,1,7,12,13,14,15,16,17,18,19,39,53,54,55,56,58,
0,1,7,23,37,38,39,40,41,42,43,44,45,57,72,87,87,
0,1,2,3,4,5,6,7,8,9,10,11,12,13,14,15,26,
0,1,7,8,9,10,11,12,13,14,15,16,17,57,57,57,57,
0,1,7,23,39,46,46,46,46,46,46,46,46,46,46,46,46,
0,1,7,13,14,15,16,17,18,19,20,21,24,39,39,39,39,
0,1,7,24,28,29,30,31,32,33,34,35,36,37,38,70,81,
0,1,7,24,39,55,65,66,67,68,69,70,71,90,91,92,94,
0,1,6,22,36,39,40,41,42,43,44,45,46,50,50,50,50,
0,1,7,9,10,11,25,25,25,25,25,25,25,25,25,25,25,
0,1,7,8,9,10,11,12,13,14,15,16,17,18,19,32,44,
0,1,8,15,16,17,18,19,20,22,32,44,45,46,47,84,98,
0,1,7,21,35,52,62,63,64,65,66,67,68,69,70,71,81,
0,1,8,25,37,41,41,41,41,41,41,41,41,41,41,41,41,
0,1,6,26,40,60,73,76,77,78,79,80,81,82,83,84,122,
0,1,7,22,37,50,68,83,84,85,86,87,88,89,92,107,107,
0,1,2,3,4,5,6,7,8,9,10,11,23,38,51,65,77,
0,1,6,7,8,9,13,31,36,36,36,36,36,36,36,36,36,
0,1,6,20,36,51,61,61,61,61,61,61,61,61,61,61,61,
0,1,7,21,35,35,35,35,35,35,35,35,35,35,35,35,35,
0,1,2,3,4,5,6,7,8,9,10,11,12,13,92,93,117,
0,1,7,21,23,24,25,26,27,28,29,35,56,67,67,67,67,
0,1,7,14,15,16,17,18,19,20,21,22,23,24,64,64,64,
0,1,7,22,36,40,41,42,43,44,45,46,47,48,49,69,81,
