author:	Mlewandowska
date:	2019-09-20 23:55	2019-09-23 09:03
concentration = 0.15, size: 300x300
distribution: Gauss	scale: 1.0
init_number_X = 50, init_number_Y = 13500	n_links = 90
k1 = 1, k2 = 1, beta = 0, lambd = 0.3
number of simulations k = 50, number of iterations n = 1000
range sampling: [0, 5, 10, 20, 30, 40, 50, 60, 70, 80, 90, 100, 110, 120, 130, 140, 150]

0,1,20,
0,1,13,
0,1,22,72,73,74,75,76,77,78,79,80,81,82,
0,1,27,95,190,235,291,302,303,304,305,306,307,308,309,348,397,
0,1,5,6,7,8,9,10,11,12,13,23,23,23,23,23,23,
0,1,23,105,180,190,190,190,190,190,190,190,190,190,190,190,190,
0,1,14,
0,1,5,5,5,5,5,5,5,5,5,5,5,5,5,5,5,
0,1,17,33,34,35,36,37,38,39,40,41,182,198,239,239,239,
0,1,22,87,
0,1,9,10,11,12,13,14,15,16,17,18,19,20,
0,1,21,59,129,251,332,
0,1,22,142,201,250,
0,1,26,
0,1,37,
0,1,13,14,15,16,17,18,19,20,21,22,23,24,25,26,70,
0,1,2,3,4,5,5,5,5,5,5,5,5,5,5,5,5,
0,1,23,72,141,146,147,148,149,150,151,152,153,328,328,328,328,
0,1,24,
0,1,27,69,
0,1,28,62,96,136,137,138,139,140,141,142,143,144,145,698,
0,1,33,47,48,49,50,51,52,53,96,211,937,938,986,
0,1,2,3,4,5,6,7,8,9,10,
0,1,29,
0,1,22,83,168,185,186,187,188,189,190,191,192,225,225,225,225,
0,1,20,62,133,204,213,214,215,216,217,218,219,220,221,222,
0,1,8,9,10,11,12,13,14,15,16,17,21,22,99,171,
0,1,19,96,123,124,125,126,127,128,129,152,153,154,155,156,250,
0,1,2,3,4,5,6,7,8,9,10,11,12,13,
0,1,14,16,17,18,19,20,21,22,23,24,25,26,27,28,
0,1,5,6,7,8,9,10,11,12,13,14,15,16,362,363,386,
0,1,12,65,113,115,115,115,115,115,115,115,115,115,115,115,115,
0,1,23,57,122,173,219,269,
0,1,7,8,9,10,11,12,13,14,15,16,17,18,19,20,244,
0,2,25,26,27,28,29,30,31,32,33,34,35,36,37,38,
0,1,30,113,
0,1,24,80,139,188,313,414,486,552,611,
0,2,24,97,149,253,
0,1,20,94,116,117,118,119,120,121,122,123,124,125,
0,1,23,25,25,25,25,25,25,25,25,25,25,25,25,25,25,
0,1,29,72,116,172,198,198,198,198,198,198,198,198,198,198,198,
0,1,21,
0,1,23,81,82,103,148,149,150,151,178,245,261,261,261,261,261,
0,1,23,78,184,237,310,350,393,408,409,410,411,412,413,
0,1,28,71,95,96,97,98,99,100,101,102,103,104,114,
0,1,35,76,77,78,79,80,81,82,116,117,118,218,293,
0,1,15,70,71,72,73,74,75,172,250,368,
0,1,25,45,45,45,45,45,45,45,45,45,45,45,45,45,45,
0,2,24,59,108,167,249,485,486,487,
0,1,15,72,136,137,138,139,140,
0,1,18,37,38,39,40,41,42,43,44,45,46,58,104,268,
0,1,5,5,5,5,5,5,5,5,5,5,5,5,5,5,5,
0,1,2,3,4,5,6,7,8,9,10,11,12,22,22,22,22,
0,1,24,53,120,121,122,123,124,125,126,127,128,129,197,285,285,
0,1,
0,1,17,
0,1,15,78,134,135,136,137,138,139,140,141,142,143,144,169,299,
0,1,14,
0,1,14,
0,1,4,5,6,7,8,9,10,11,12,13,14,15,16,
0,1,23,
0,2,35,65,124,167,210,290,290,290,290,290,290,290,290,290,290,
0,1,18,59,124,192,223,223,223,223,223,223,223,223,223,223,223,
0,1,24,130,177,
0,1,24,98,158,158,158,158,158,158,158,158,158,158,158,158,158,
0,1,20,68,153,
0,1,28,
0,2,12,12,12,12,12,12,12,12,12,12,12,12,12,12,12,
0,3,4,5,6,7,8,9,10,32,114,115,116,117,210,215,273,
0,1,63,
0,1,21,25,25,25,25,25,25,25,25,25,25,25,25,25,25,
0,1,15,66,67,68,69,70,71,72,73,74,75,76,77,84,451,
0,1,2,3,4,5,6,7,8,9,10,11,
0,1,21,67,126,149,150,151,152,153,154,354,355,356,357,358,700,
0,1,18,62,70,71,72,73,74,75,
0,1,5,6,7,8,9,10,121,172,173,174,175,176,
0,1,32,71,144,145,146,147,148,149,150,194,
0,1,2,3,4,5,6,7,8,9,10,11,12,13,14,15,23,
0,1,13,14,15,16,17,18,19,20,21,22,23,24,368,
0,1,28,
0,1,8,9,10,11,12,13,14,15,16,17,18,46,78,193,229,
0,1,21,63,
0,1,2,3,4,5,6,7,8,9,10,198,199,
0,1,22,
0,2,23,24,25,26,27,28,29,30,31,32,33,34,
0,1,15,83,136,204,234,235,235,235,235,235,235,235,235,235,235,
0,1,29,41,41,41,41,41,41,41,41,41,41,41,41,41,41,
0,1,33,69,79,79,79,79,79,79,79,79,79,79,79,79,79,
0,1,2,3,4,5,6,7,8,9,10,11,12,
0,1,25,125,199,283,331,437,
0,1,3,4,5,6,7,8,9,10,11,12,
0,1,21,28,29,30,31,32,33,34,35,36,37,38,39,49,91,
0,1,24,
0,1,20,68,129,142,143,144,145,146,147,148,149,150,151,
0,1,28,55,56,57,58,59,60,61,62,63,64,124,222,277,541,
0,1,17,21,22,23,24,25,26,27,28,70,
0,3,22,40,41,42,55,81,81,81,81,81,81,81,81,81,81,
0,1,27,
0,1,
0,1,24,72,155,205,206,207,208,209,210,211,226,361,415,559,559,
0,1,27,79,140,168,169,170,291,292,569,
0,1,9,52,80,80,80,80,80,80,80,80,80,80,80,80,80,
0,2,17,113,
0,1,16,63,65,66,67,68,69,70,71,72,73,74,75,87,138,
0,1,
0,1,2,3,4,5,73,104,105,106,107,108,109,110,150,309,309,
0,1,19,28,28,28,28,28,28,28,28,28,28,28,28,28,28,
0,1,17,59,59,59,59,59,59,59,59,59,59,59,59,59,59,
0,2,43,56,56,56,56,56,56,56,56,56,56,56,56,56,56,
0,1,24,66,122,159,159,159,159,159,159,159,159,159,159,159,159,
0,1,18,68,120,161,161,161,161,161,161,161,161,161,161,161,161,
0,1,2,3,4,5,6,7,8,9,10,11,24,74,136,191,372,
0,1,29,129,195,
0,1,26,
0,1,17,61,159,
0,1,21,68,191,241,300,301,302,303,304,305,
0,1,18,48,49,50,51,52,53,54,55,117,117,117,117,117,117,
0,1,28,
0,1,15,53,54,55,56,57,58,59,60,61,62,63,64,65,
0,1,49,157,
0,1,37,
0,1,24,38,39,40,41,42,43,44,45,46,47,
0,1,36,87,
0,1,14,61,81,82,83,84,85,86,87,88,89,90,91,92,270,
0,1,28,79,151,235,
0,1,15,86,104,105,106,107,108,109,110,111,112,113,114,164,197,
0,1,25,65,65,65,65,65,65,65,65,65,65,65,65,65,65,
0,1,24,83,164,
0,1,4,5,6,7,8,9,10,11,12,71,71,71,71,71,71,
0,1,16,63,135,
0,1,22,62,92,93,94,95,96,114,241,340,
0,1,20,62,62,62,62,62,62,62,62,62,62,62,62,62,62,
0,1,6,7,8,9,10,11,12,13,14,15,16,17,
0,1,19,82,134,200,258,308,430,512,603,604,605,
0,1,17,57,99,106,106,106,106,106,106,106,106,106,106,106,106,
0,1,25,84,134,134,134,134,134,134,134,134,134,134,134,134,134,
0,1,26,123,195,245,
0,1,29,96,137,202,203,204,205,206,
0,1,6,7,8,9,98,99,100,101,102,
0,2,27,92,180,281,
0,1,3,3,3,3,3,3,3,3,3,3,3,3,3,3,3,
0,2,31,107,
0,1,24,68,69,70,71,72,73,74,75,76,77,78,79,176,200,
0,1,2,3,4,5,6,47,48,49,50,83,84,85,96,231,332,
0,1,21,115,183,
0,1,19,57,69,70,71,72,73,74,75,76,77,78,181,375,375,
0,1,24,
0,1,22,36,
0,1,19,58,222,287,
0,1,29,52,53,54,55,56,57,58,59,60,61,62,63,220,220,
0,1,20,63,65,66,67,68,69,70,71,72,73,74,75,
0,1,5,6,7,8,9,10,11,12,13,14,15,16,44,47,73,
0,1,6,7,8,9,10,11,12,13,14,15,16,17,18,110,110,
0,1,22,
0,1,25,102,150,279,293,294,295,296,411,411,411,411,411,411,411,
0,1,19,65,66,67,68,69,70,71,72,73,74,75,76,98,609,
0,1,20,69,121,255,318,381,764,764,764,764,764,764,764,764,764,
0,1,21,63,103,160,241,283,305,306,307,308,309,309,309,309,309,
0,1,22,78,122,122,122,122,122,122,122,122,122,122,122,122,122,
0,1,19,58,116,117,136,178,179,180,181,182,183,184,650,650,650,
0,1,20,100,
0,1,22,70,93,93,93,93,93,93,93,93,93,93,93,93,93,
0,1,17,56,117,118,119,120,121,122,123,124,125,126,127,177,392,
0,1,14,15,16,17,18,19,29,75,143,281,
0,1,24,101,
0,1,18,53,53,53,53,53,53,53,53,53,53,53,53,53,53,
0,1,22,61,132,
0,1,29,33,34,35,36,37,38,39,177,178,215,285,337,372,464,
0,1,18,
0,1,21,57,58,59,60,61,62,63,64,65,66,67,68,69,
0,1,10,74,
0,1,17,98,151,203,204,205,206,207,208,209,210,
0,1,12,106,119,120,121,122,123,124,125,132,206,206,206,206,206,
0,1,18,72,73,74,75,76,77,78,79,80,81,82,83,147,
0,1,17,88,132,132,132,132,132,132,132,132,132,132,132,132,132,
0,1,22,
0,1,20,89,164,
0,1,21,49,50,51,52,53,54,55,56,57,58,203,203,203,203,
0,1,22,23,24,25,26,27,28,29,30,31,32,
0,1,21,97,148,155,156,157,158,159,160,161,
0,1,34,73,125,126,127,128,129,130,131,132,133,134,135,138,138,
0,1,20,70,111,112,153,213,214,215,216,217,230,278,303,303,303,
0,1,34,87,
0,1,16,24,25,26,27,28,29,30,
0,1,20,65,135,180,260,331,383,424,492,
0,1,2,3,4,5,6,7,8,9,10,11,12,13,14,15,
0,1,16,92,146,245,331,393,511,596,597,598,599,599,599,599,599,
0,1,17,18,19,20,21,22,23,24,25,26,37,52,52,52,52,
0,1,24,84,
0,1,19,78,
0,1,19,100,156,
0,1,9,9,9,9,9,9,9,9,9,9,9,9,9,9,9,
0,1,2,3,4,5,6,7,8,9,10,11,12,13,49,140,162,
0,1,19,76,
0,1,19,45,46,47,48,49,50,155,156,157,158,159,160,184,227,
0,1,11,12,13,14,15,16,17,18,19,20,21,22,23,246,246,
0,1,18,19,20,21,22,23,24,25,26,27,28,39,115,183,
0,1,19,67,141,226,245,246,247,248,309,327,384,450,
0,1,20,148,194,242,
0,1,24,78,82,83,84,85,86,87,88,89,152,153,154,160,213,
0,1,25,29,30,31,32,71,72,73,117,168,549,550,551,601,986,
0,1,17,69,69,69,69,69,69,69,69,69,69,69,69,69,69,
0,1,13,14,15,16,17,18,19,20,21,22,23,292,292,292,292,
0,1,2,2,2,2,2,2,2,2,2,2,2,2,2,2,2,
0,1,9,76,
0,1,20,83,139,
0,1,23,25,25,25,25,25,25,25,25,25,25,25,25,25,25,
0,1,23,
0,1,16,69,93,93,93,93,93,93,93,93,93,93,93,93,93,
0,1,16,88,118,119,120,121,122,123,124,125,248,249,250,261,311,
0,1,2,3,4,5,6,7,8,9,10,11,12,13,
0,1,19,61,62,63,64,65,66,67,68,69,
0,3,25,
0,1,17,57,115,172,175,175,175,175,175,175,175,175,175,175,175,
0,1,2,3,4,5,6,7,8,9,10,25,87,88,89,98,
0,1,3,4,5,6,7,8,9,10,11,12,13,14,54,109,164,
0,1,24,28,29,30,31,32,33,34,35,
0,1,14,76,118,123,124,152,152,152,152,152,152,152,152,152,152,
0,1,19,132,132,132,132,132,132,132,132,132,132,132,132,132,132,
0,1,18,76,153,154,155,156,157,158,159,160,161,162,163,181,246,
0,1,18,62,73,74,75,76,77,78,79,80,81,82,83,84,432,
0,1,17,26,27,28,29,30,31,47,145,146,147,148,149,319,361,
0,1,28,46,46,46,46,46,46,46,46,46,46,46,46,46,46,
0,2,14,15,16,17,18,19,20,21,22,23,24,25,26,27,409,
0,1,6,7,8,9,10,11,12,13,14,15,16,17,18,
0,1,26,35,36,37,38,39,40,41,42,43,44,45,46,49,66,
0,1,9,10,11,12,13,14,15,16,17,18,19,20,21,524,524,
0,1,4,5,6,7,8,9,10,11,11,11,11,11,11,11,11,
0,1,21,94,94,94,94,94,94,94,94,94,94,94,94,94,94,
0,1,16,65,164,
0,1,18,66,67,68,69,70,71,72,73,74,75,76,77,176,176,
0,1,11,12,13,14,15,16,17,18,19,20,21,22,23,24,71,
0,1,24,93,151,
0,1,14,
0,1,19,55,58,59,60,61,62,63,64,65,66,67,68,69,
0,1,18,
0,1,5,6,7,8,
0,1,20,
0,1,8,9,10,11,12,13,14,15,16,17,324,325,326,327,
0,1,
0,1,35,
0,1,20,79,
0,1,22,54,54,54,54,54,54,54,54,54,54,54,54,54,54,
0,1,22,
0,1,29,71,72,73,74,75,76,77,78,79,80,81,82,152,152,
0,1,25,81,125,169,169,169,169,169,169,169,169,169,169,169,169,
0,1,7,8,9,10,11,12,89,177,300,300,300,300,300,300,300,
0,1,2,3,4,5,6,
0,1,16,63,
0,1,5,6,7,8,9,10,11,12,13,14,15,16,82,82,82,
0,1,22,72,130,244,245,246,247,248,249,250,251,252,253,315,379,
0,1,26,101,146,226,294,356,360,360,360,360,360,360,360,360,360,
0,2,23,90,136,208,270,315,367,491,656,694,694,694,694,694,694,
0,1,4,5,6,7,8,9,10,11,12,13,150,151,194,268,560,
0,1,27,64,112,179,237,346,347,348,349,350,351,357,451,452,
0,1,20,25,26,27,28,125,126,127,128,186,187,188,285,340,394,
0,1,34,106,117,118,119,120,121,122,123,124,125,
0,1,19,63,104,145,146,147,148,149,150,151,152,153,162,207,641,
0,1,18,85,135,
0,1,40,120,120,120,120,120,120,120,120,120,120,120,120,120,120,
0,1,19,
0,1,11,
0,1,16,118,160,234,306,
0,1,13,
0,1,17,66,132,166,167,168,169,170,171,172,433,434,435,435,435,
0,1,24,54,55,56,57,58,59,60,61,62,63,64,
0,1,3,4,5,6,7,8,9,10,19,
0,1,23,81,
0,1,26,27,28,29,30,31,32,33,34,35,82,83,84,85,220,
0,1,16,83,123,148,149,154,177,178,179,180,181,183,183,183,183,
0,1,18,70,146,181,182,183,184,185,186,187,188,189,262,
0,1,
0,1,16,54,98,230,231,232,233,234,
0,1,19,48,49,50,51,52,53,54,55,56,57,58,340,341,
0,0,0,0,0,0,0,0,0,0,0,0,0,0,0,0,0,
0,1,20,57,57,57,57,57,57,57,57,57,57,57,57,57,57,
0,1,19,80,128,
0,1,19,65,91,91,91,91,91,91,91,91,91,91,91,91,91,
0,1,6,7,8,9,10,11,12,13,14,15,16,17,414,545,648,
0,1,22,35,35,35,35,35,35,35,35,35,35,35,35,35,35,
0,2,29,85,
0,1,20,87,138,248,249,250,
0,1,13,61,97,98,137,179,
0,1,11,62,129,277,332,389,438,505,506,507,508,564,612,696,696,
0,1,30,67,156,230,
0,1,9,10,11,12,13,14,15,16,17,18,87,134,137,137,137,
0,1,21,56,
0,1,27,74,178,225,230,230,230,230,230,230,230,230,230,230,230,
0,1,16,42,42,42,42,42,42,42,42,42,42,42,42,42,42,
0,1,24,89,135,149,150,151,152,153,154,155,156,157,159,263,277,
0,1,14,67,103,103,103,103,103,103,103,103,103,103,103,103,103,
0,1,6,7,8,9,10,11,12,13,14,15,60,60,60,60,60,
0,1,18,35,36,37,38,39,40,41,42,43,44,45,64,65,97,
0,1,40,82,83,84,85,86,87,88,89,90,91,92,93,94,134,
0,1,24,110,229,
0,1,10,10,10,10,10,10,10,10,10,10,10,10,10,10,10,
0,1,21,69,86,87,88,89,90,91,92,93,257,257,257,257,257,
0,1,4,5,6,7,8,8,8,8,8,8,8,8,8,8,8,
0,1,5,5,5,5,5,5,5,5,5,5,5,5,5,5,5,
0,1,5,6,7,8,9,10,48,120,201,202,203,204,205,238,238,
0,2,15,16,16,16,16,16,16,16,16,16,16,16,16,16,16,
0,1,19,
0,1,25,84,141,147,148,280,281,282,283,284,285,286,318,413,
0,1,22,24,25,26,27,28,29,30,31,32,33,34,78,125,156,
0,1,19,32,33,34,35,36,37,38,39,40,40,40,40,40,40,
0,1,2,3,4,5,6,7,28,48,49,139,139,139,139,139,139,
0,1,24,85,149,193,221,222,223,224,254,
0,1,23,98,
0,1,26,81,95,96,97,98,99,100,
0,1,24,72,134,135,136,137,138,139,140,141,142,143,207,208,244,
0,1,20,88,132,135,391,499,
0,1,17,
0,1,21,33,34,35,36,
0,1,24,67,
0,1,39,
0,1,2,3,4,5,6,7,8,8,8,8,8,8,8,8,8,
0,1,33,83,84,85,86,87,88,89,90,91,92,93,94,95,
0,1,13,103,
0,1,30,64,114,208,
0,1,18,57,58,59,60,61,62,63,64,103,184,
0,1,32,104,105,106,107,108,109,110,111,112,113,114,115,145,
0,2,26,80,80,80,80,80,80,80,80,80,80,80,80,80,80,
0,1,21,82,123,196,197,198,199,200,201,202,203,204,288,288,288,
0,1,8,8,8,8,8,8,8,8,8,8,8,8,8,8,8,
0,1,23,66,167,167,167,167,167,167,167,167,167,167,167,167,167,
0,1,18,55,130,137,138,139,140,141,142,143,144,145,
0,1,19,72,75,75,75,75,75,75,75,75,75,75,75,75,75,
0,1,24,76,89,90,91,92,93,94,95,96,97,98,99,
0,1,21,67,118,
0,1,2,3,4,5,6,7,8,76,77,78,79,80,81,242,242,
0,1,17,94,137,
0,1,12,12,12,12,12,12,12,12,12,12,12,12,12,12,12,
0,1,14,44,45,46,47,48,49,50,63,131,310,310,310,310,310,
0,1,18,70,115,144,145,146,147,148,149,150,174,175,224,224,224,
0,1,19,135,
0,1,14,54,55,56,57,58,59,60,61,62,63,64,65,66,109,
0,1,15,72,
0,1,35,115,173,174,180,232,263,264,265,300,321,579,701,747,747,
0,1,26,77,165,225,
0,1,8,9,10,11,12,13,14,15,16,17,18,19,53,219,292,
0,1,36,73,73,73,73,73,73,73,73,73,73,73,73,73,73,
0,1,4,5,5,5,5,5,5,5,5,5,5,5,5,5,5,
0,1,28,69,122,123,124,125,126,127,128,129,130,160,231,290,309,
0,1,17,73,109,110,111,112,113,114,115,116,117,118,140,193,238,
0,1,22,
0,1,30,75,146,152,153,154,155,156,157,158,159,160,161,162,330,
0,1,2,3,4,5,6,7,8,9,10,11,12,13,14,15,
0,1,25,94,
0,1,2,3,4,5,6,7,8,25,25,25,25,25,25,25,25,
0,1,4,5,6,44,44,44,44,44,44,44,44,44,44,44,44,
