author:	Mlewandowska
date:	2019-09-20 23:55	2019-09-23 09:03
concentration = 0.15, size: 300x300
distribution: Gauss	scale: 1.0
init_number_X = 50, init_number_Y = 13500	n_links = 90
k1 = 1, k2 = 1, beta = 0, lambd = 0.3
number of simulations k = 50, number of iterations n = 1000
range sampling: [0, 5, 10, 20, 30, 40, 50, 60, 70, 80, 90, 100, 110, 120, 130, 140, 150]

0,1,20,
0,1,13,
0,1,22,72,73,74,75,76,77,78,79,80,81,82,
0,1,27,95,190,235,291,302,303,304,305,306,307,308,309,348,397,
0,1,5,6,7,8,9,10,11,12,13,23,23,23,23,23,23,
0,1,20,83,139,
0,1,23,25,25,25,25,25,25,25,25,25,25,25,25,25,25,
0,1,23,
0,1,16,69,93,93,93,93,93,93,93,93,93,93,93,93,93,
0,1,16,88,118,119,120,121,122,123,124,125,248,249,250,261,311,
0,1,2,3,4,5,6,7,8,9,10,11,12,13,
0,1,19,61,62,63,64,65,66,67,68,69,
0,3,25,
0,1,17,57,115,172,175,175,175,175,175,175,175,175,175,175,175,
0,1,2,3,4,5,6,7,8,9,10,25,87,88,89,98,
0,1,3,4,5,6,7,8,9,10,11,12,13,14,54,109,164,
0,1,24,28,29,30,31,32,33,34,35,
0,1,14,76,118,123,124,152,152,152,152,152,152,152,152,152,152,
0,1,19,132,132,132,132,132,132,132,132,132,132,132,132,132,132,
0,1,18,76,153,154,155,156,157,158,159,160,161,162,163,181,246,
0,1,18,62,73,74,75,76,77,78,79,80,81,82,83,84,432,
0,1,17,26,27,28,29,30,31,47,145,146,147,148,149,319,361,
0,1,28,46,46,46,46,46,46,46,46,46,46,46,46,46,46,
0,2,14,15,16,17,18,19,20,21,22,23,24,25,26,27,409,
0,1,6,7,8,9,10,11,12,13,14,15,16,17,18,
0,1,26,35,36,37,38,39,40,41,42,43,44,45,46,49,66,
0,1,9,10,11,12,13,14,15,16,17,18,19,20,21,524,524,
0,1,4,5,6,7,8,9,10,11,11,11,11,11,11,11,11,
0,1,21,94,94,94,94,94,94,94,94,94,94,94,94,94,94,
0,1,16,65,164,
0,1,18,66,67,68,69,70,71,72,73,74,75,76,77,176,176,
0,1,11,12,13,14,15,16,17,18,19,20,21,22,23,24,71,
0,1,24,93,151,
0,1,14,
0,1,19,55,58,59,60,61,62,63,64,65,66,67,68,69,
0,1,18,
0,1,5,6,7,8,
0,1,20,
0,1,8,9,10,11,12,13,14,15,16,17,324,325,326,327,
0,1,
0,1,35,
0,1,20,79,
0,1,22,54,54,54,54,54,54,54,54,54,54,54,54,54,54,
0,1,22,
0,1,29,71,72,73,74,75,76,77,78,79,80,81,82,152,152,
0,1,25,81,125,169,169,169,169,169,169,169,169,169,169,169,169,
0,1,7,8,9,10,11,12,89,177,300,300,300,300,300,300,300,
0,1,2,3,4,5,6,
0,1,16,63,
0,1,5,6,7,8,9,10,11,12,13,14,15,16,82,82,82,
0,1,22,72,130,244,245,246,247,248,249,250,251,252,253,315,379,
0,1,26,101,146,226,294,356,360,360,360,360,360,360,360,360,360,
0,2,23,90,136,208,270,315,367,491,656,694,694,694,694,694,694,
0,1,4,5,6,7,8,9,10,11,12,13,150,151,194,268,560,
0,1,27,64,112,179,237,346,347,348,349,350,351,357,451,452,
0,1,20,25,26,27,28,125,126,127,128,186,187,188,285,340,394,
0,1,34,106,117,118,119,120,121,122,123,124,125,
0,1,19,63,104,145,146,147,148,149,150,151,152,153,162,207,641,
0,1,18,85,135,
0,1,40,120,120,120,120,120,120,120,120,120,120,120,120,120,120,
0,1,19,
0,1,11,
0,1,16,118,160,234,306,
0,1,13,
0,1,17,66,132,166,167,168,169,170,171,172,433,434,435,435,435,
0,1,24,54,55,56,57,58,59,60,61,62,63,64,
0,1,3,4,5,6,7,8,9,10,19,
0,1,23,81,
0,1,26,27,28,29,30,31,32,33,34,35,82,83,84,85,220,
0,1,16,83,123,148,149,154,177,178,179,180,181,183,183,183,183,
0,1,18,70,146,181,182,183,184,185,186,187,188,189,262,
0,1,
0,1,16,54,98,230,231,232,233,234,
0,1,19,48,49,50,51,52,53,54,55,56,57,58,340,341,
0,0,0,0,0,0,0,0,0,0,0,0,0,0,0,0,0,
0,1,20,57,57,57,57,57,57,57,57,57,57,57,57,57,57,
0,1,19,80,128,
0,1,19,65,91,91,91,91,91,91,91,91,91,91,91,91,91,
0,1,6,7,8,9,10,11,12,13,14,15,16,17,414,545,648,
0,1,22,35,35,35,35,35,35,35,35,35,35,35,35,35,35,
0,2,29,85,
0,1,20,87,138,248,249,250,
0,1,13,61,97,98,137,179,
0,1,11,62,129,277,332,389,438,505,506,507,508,564,612,696,696,
0,1,30,67,156,230,
0,1,9,10,11,12,13,14,15,16,17,18,87,134,137,137,137,
0,1,21,56,
0,1,27,74,178,225,230,230,230,230,230,230,230,230,230,230,230,
0,1,16,42,42,42,42,42,42,42,42,42,42,42,42,42,42,
0,1,24,89,135,149,150,151,152,153,154,155,156,157,159,263,277,
0,1,14,67,103,103,103,103,103,103,103,103,103,103,103,103,103,
0,1,6,7,8,9,10,11,12,13,14,15,60,60,60,60,60,
0,1,18,35,36,37,38,39,40,41,42,43,44,45,64,65,97,
0,1,40,82,83,84,85,86,87,88,89,90,91,92,93,94,134,
0,1,24,110,229,
0,1,10,10,10,10,10,10,10,10,10,10,10,10,10,10,10,
0,1,21,69,86,87,88,89,90,91,92,93,257,257,257,257,257,
0,1,4,5,6,7,8,8,8,8,8,8,8,8,8,8,8,
0,1,5,5,5,5,5,5,5,5,5,5,5,5,5,5,5,
0,1,5,6,7,8,9,10,48,120,201,202,203,204,205,238,238,
0,2,15,16,16,16,16,16,16,16,16,16,16,16,16,16,16,
0,1,19,
0,1,25,84,141,147,148,280,281,282,283,284,285,286,318,413,
0,1,22,24,25,26,27,28,29,30,31,32,33,34,78,125,156,
0,1,19,32,33,34,35,36,37,38,39,40,40,40,40,40,40,
0,1,2,3,4,5,6,7,28,48,49,139,139,139,139,139,139,
0,1,24,85,149,193,221,222,223,224,254,
0,1,23,98,
0,1,26,81,95,96,97,98,99,100,
0,1,24,72,134,135,136,137,138,139,140,141,142,143,207,208,244,
0,1,20,88,132,135,391,499,
0,1,17,
0,1,21,33,34,35,36,
0,1,24,67,
0,1,39,
0,1,2,3,4,5,6,7,8,8,8,8,8,8,8,8,8,
0,1,33,83,84,85,86,87,88,89,90,91,92,93,94,95,
0,1,13,103,
0,1,30,64,114,208,
0,1,18,57,58,59,60,61,62,63,64,103,184,
0,1,32,104,105,106,107,108,109,110,111,112,113,114,115,145,
0,2,26,80,80,80,80,80,80,80,80,80,80,80,80,80,80,
0,1,21,82,123,196,197,198,199,200,201,202,203,204,288,288,288,
0,1,8,8,8,8,8,8,8,8,8,8,8,8,8,8,8,
0,1,23,66,167,167,167,167,167,167,167,167,167,167,167,167,167,
0,1,18,55,130,137,138,139,140,141,142,143,144,145,
0,1,19,72,75,75,75,75,75,75,75,75,75,75,75,75,75,
0,1,24,76,89,90,91,92,93,94,95,96,97,98,99,
0,1,21,67,118,
0,1,2,3,4,5,6,7,8,76,77,78,79,80,81,242,242,
0,1,17,94,137,
0,1,12,12,12,12,12,12,12,12,12,12,12,12,12,12,12,
0,1,14,44,45,46,47,48,49,50,63,131,310,310,310,310,310,
0,1,18,70,115,144,145,146,147,148,149,150,174,175,224,224,224,
0,1,19,135,
0,1,14,54,55,56,57,58,59,60,61,62,63,64,65,66,109,
0,1,15,72,
0,1,35,115,173,174,180,232,263,264,265,300,321,579,701,747,747,
0,1,26,77,165,225,
0,1,8,9,10,11,12,13,14,15,16,17,18,19,53,219,292,
0,1,36,73,73,73,73,73,73,73,73,73,73,73,73,73,73,
0,1,4,5,5,5,5,5,5,5,5,5,5,5,5,5,5,
0,1,28,69,122,123,124,125,126,127,128,129,130,160,231,290,309,
0,1,17,73,109,110,111,112,113,114,115,116,117,118,140,193,238,
0,1,22,
0,1,30,75,146,152,153,154,155,156,157,158,159,160,161,162,330,
0,1,2,3,4,5,6,7,8,9,10,11,12,13,14,15,
0,1,25,94,
0,1,2,3,4,5,6,7,8,25,25,25,25,25,25,25,25,
0,1,4,5,6,44,44,44,44,44,44,44,44,44,44,44,44,
