author:	Mlewandowska
date:	2019-09-06 08:53	2019-09-06 13:43
concentration = 0.15, size: 300x300
distribution: Gauss	scale: 1.0
init_number_X = 50, init_number_Y = 13500	n_links = 90
k1 = 1, k2 = 1, beta = 0, lambd = 0.7
number of simulations k = 25, number of iterations n = 1000
range sampling: [0, 5, 10, 20, 30, 40, 50, 60, 70, 80, 90, 100, 110, 120, 130, 140, 150]

0,1,7,15,16,17,18,19,20,21,22,23,24,32,72,98,123,
0,1,11,29,30,31,32,33,34,35,36,37,38,39,40,41,82,
0,1,11,29,52,77,78,79,80,81,82,83,84,85,91,96,112,
0,1,11,33,50,51,52,53,54,55,56,57,58,93,93,93,93,
0,1,9,33,33,33,33,33,33,33,33,33,33,33,33,33,33,
0,1,9,18,19,20,21,22,23,24,25,26,27,28,29,40,48,
0,1,10,32,60,60,60,60,60,60,60,60,60,60,60,60,60,
0,1,2,3,4,5,6,7,19,64,64,64,64,64,64,64,64,
0,1,10,32,55,83,111,123,123,123,123,123,123,123,123,123,123,
0,1,10,
0,1,2,3,4,5,6,7,8,9,10,54,55,56,57,76,110,
0,1,5,6,7,8,9,10,11,18,19,20,21,22,23,30,75,
0,1,10,16,17,18,19,20,21,22,23,24,25,26,26,26,26,
0,1,10,12,12,12,12,12,12,12,12,12,12,12,12,12,12,
0,1,8,27,47,54,55,56,57,58,59,60,61,62,63,64,127,
0,1,2,3,4,5,6,7,8,9,10,11,12,38,38,38,38,
0,1,8,14,15,16,17,18,19,20,21,22,23,24,25,37,56,
0,1,8,35,109,125,148,173,192,193,194,195,196,197,197,197,197,
0,1,9,32,43,44,45,46,47,48,49,50,50,50,50,50,50,
0,1,9,21,22,23,24,24,24,24,24,24,24,24,24,24,24,
0,1,9,25,26,27,28,29,30,31,32,33,34,41,56,103,124,
0,1,8,29,43,44,45,45,45,45,45,45,45,45,45,45,45,
0,1,3,4,5,6,10,14,15,16,17,18,19,20,21,22,104,
0,1,10,33,37,38,39,40,41,42,43,44,45,55,78,102,132,
0,1,10,33,64,65,66,67,68,69,70,71,72,73,74,75,90,
0,1,10,33,37,37,37,37,37,37,37,37,37,37,37,37,37,
0,1,11,32,52,56,57,58,59,60,61,105,105,105,105,105,105,
0,1,8,31,55,59,59,59,59,59,59,59,59,59,59,59,59,
0,1,10,16,17,18,19,19,19,19,19,19,19,19,19,19,19,
0,1,2,3,4,5,10,28,48,54,55,56,57,58,59,60,62,
0,1,10,30,51,70,70,70,70,70,70,70,70,70,70,70,70,
0,1,9,13,14,15,16,17,63,64,65,66,67,68,69,70,169,
0,1,9,29,33,34,35,36,37,42,42,42,42,42,42,42,42,
0,1,2,3,4,5,6,7,8,9,10,11,12,69,69,69,69,
0,1,8,29,55,76,94,95,96,97,98,99,100,101,102,137,163,
0,1,8,23,23,23,23,23,23,23,23,23,23,23,23,23,23,
0,1,9,29,58,65,66,67,83,112,112,112,112,112,112,112,112,
0,1,10,29,50,56,56,56,56,56,56,56,56,56,56,56,56,
0,1,8,35,53,54,55,56,57,57,57,57,57,57,57,57,57,
0,1,10,22,22,22,22,22,22,22,22,22,22,22,22,22,22,
0,1,3,4,5,6,7,25,73,89,95,104,105,106,107,113,120,
0,1,9,10,11,12,13,14,56,56,56,56,56,56,56,56,56,
0,1,6,7,8,9,10,11,12,13,14,15,16,17,18,44,44,
0,1,8,19,20,21,22,23,24,25,26,27,28,112,130,130,130,
0,1,12,28,29,30,31,32,33,34,35,81,81,81,81,81,81,
0,1,9,31,57,58,59,60,61,62,63,64,65,75,169,178,196,
0,1,9,35,37,37,37,37,37,37,37,37,37,37,37,37,37,
0,1,10,34,35,36,37,38,39,40,41,42,43,44,45,46,70,
0,1,9,32,40,41,42,43,44,45,67,85,85,85,85,85,85,
0,1,2,3,4,5,6,7,8,9,10,22,27,27,27,27,27,
0,1,8,22,22,22,22,22,22,22,22,22,22,22,22,22,22,
0,1,4,5,6,7,8,9,10,11,12,13,14,15,30,56,106,
0,1,2,3,4,5,6,7,8,9,10,11,12,13,20,48,51,
0,1,13,32,53,55,56,57,58,59,60,61,62,63,64,65,94,
0,1,10,28,50,51,52,53,54,55,56,57,58,59,76,77,88,
0,1,9,34,57,64,65,66,67,73,74,75,76,77,92,114,126,
0,1,8,31,48,80,91,92,93,94,95,96,98,110,110,110,110,
0,1,7,21,22,23,24,25,26,27,28,29,30,59,59,59,59,
0,1,1,1,1,1,1,1,1,1,1,1,1,1,1,1,1,
0,1,9,37,61,83,84,85,86,87,88,89,90,91,175,175,175,
0,1,7,7,7,7,7,7,7,7,7,7,7,7,7,7,7,
0,1,5,5,5,5,5,5,5,5,5,5,5,5,5,5,5,
0,1,11,32,54,54,54,54,54,54,54,54,54,54,54,54,54,
0,1,9,19,20,21,22,22,22,22,22,22,22,22,22,22,22,
0,1,9,22,23,24,32,33,34,35,36,37,38,39,40,44,44,
0,1,11,15,16,39,40,41,42,43,44,45,62,63,67,68,78,
0,1,11,12,13,14,15,16,17,18,19,25,48,49,50,70,92,
0,1,9,30,30,30,30,30,30,30,30,30,30,30,30,30,30,
0,1,10,39,65,84,98,99,100,101,102,103,121,124,125,158,158,
0,1,14,24,25,26,27,28,29,30,31,32,33,34,35,36,38,
0,1,10,35,53,73,93,95,96,97,98,99,100,101,102,103,209,
0,1,10,34,60,
0,1,8,22,23,24,25,26,27,135,136,137,138,139,140,141,161,
0,1,11,29,30,31,32,52,53,54,55,56,57,86,87,88,151,
0,1,10,28,51,65,65,65,65,65,65,65,65,65,65,65,65,
0,1,1,1,1,1,1,1,1,1,1,1,1,1,1,1,1,
0,1,9,40,63,81,83,84,85,86,87,102,109,113,114,115,126,
0,1,9,20,21,22,23,24,43,43,43,43,43,43,43,43,43,
0,1,7,26,46,47,48,49,50,51,52,53,54,55,56,57,77,
0,1,10,32,33,34,35,36,37,38,39,40,41,60,63,64,71,
0,1,10,29,57,84,112,132,155,174,180,181,182,183,184,185,219,
0,1,9,24,24,24,24,24,24,24,24,24,24,24,24,24,24,
0,1,7,31,55,104,114,115,117,118,119,120,171,171,171,171,171,
0,1,9,32,54,69,70,81,82,83,84,85,86,87,88,126,149,
0,1,9,17,18,19,20,21,22,23,24,25,26,27,28,29,40,
0,1,2,3,4,5,6,7,8,9,10,11,36,57,58,58,58,
0,1,9,39,70,88,96,96,96,96,96,96,96,96,96,96,96,
0,1,8,31,54,79,81,82,83,84,85,86,87,88,113,134,134,
0,1,10,20,21,34,35,37,45,46,47,48,49,50,51,52,117,
0,1,9,31,53,73,74,75,76,77,78,180,180,180,180,180,180,
0,1,9,32,41,41,41,41,41,41,41,41,41,41,41,41,41,
0,0,0,0,0,0,0,0,0,0,0,0,0,0,0,0,0,
0,1,9,32,33,33,33,33,33,33,33,33,33,33,33,33,33,
0,1,7,8,9,10,11,12,28,54,55,59,82,89,89,89,89,
0,1,2,3,4,5,6,7,8,14,57,66,67,68,74,75,75,
0,1,4,5,6,7,8,9,10,11,12,13,17,18,19,20,33,
0,1,6,6,6,6,6,6,6,6,6,6,6,6,6,6,6,
0,1,4,5,23,23,23,23,23,23,23,23,23,23,23,23,23,
0,1,11,30,35,36,37,38,39,40,41,41,41,41,41,41,41,
0,1,9,35,60,84,96,97,100,101,101,101,101,101,101,101,101,
0,1,8,22,23,24,25,26,27,28,29,30,37,38,39,40,53,
0,1,7,25,54,55,56,57,58,59,60,61,62,63,71,71,71,
0,1,10,27,65,65,65,65,65,65,65,65,65,65,65,65,65,
0,1,2,3,4,5,6,7,8,9,33,33,33,33,33,33,33,
0,1,10,34,55,56,57,58,59,60,61,62,69,70,71,72,76,
0,1,2,3,4,5,6,7,8,9,10,11,12,13,14,31,54,
0,1,8,32,45,46,47,48,49,50,51,52,100,137,137,137,137,
0,1,2,3,4,5,6,7,8,9,10,11,12,33,34,34,34,
0,1,7,32,56,66,67,68,69,70,71,72,73,74,75,76,136,
0,1,10,22,23,24,25,26,27,28,29,30,44,65,67,74,79,
0,1,2,3,4,5,6,7,8,9,10,11,12,77,77,77,77,
0,1,12,42,66,89,90,90,90,90,90,90,90,90,90,90,90,
0,1,13,30,30,30,30,30,30,30,30,30,30,30,30,30,30,
0,1,10,34,35,36,37,38,39,40,43,44,45,46,47,48,61,
0,1,8,19,20,21,22,23,30,55,58,59,64,64,64,64,64,
0,1,8,34,49,50,51,52,53,56,57,58,59,60,73,109,109,
0,1,7,8,9,10,11,12,13,14,15,16,31,54,54,54,54,
0,1,10,17,18,19,20,21,22,23,23,23,23,23,23,23,23,
0,1,11,31,32,33,34,35,36,37,38,39,40,40,40,40,40,
0,1,9,31,53,61,62,63,64,65,66,67,68,69,70,91,91,
0,1,9,38,49,49,49,49,49,49,49,49,49,49,49,49,49,
0,1,12,
0,1,2,3,4,5,6,7,8,9,10,11,31,69,70,71,85,
0,1,12,33,55,78,94,95,96,97,98,99,100,101,102,103,149,
0,1,9,30,31,32,33,34,35,47,48,76,100,113,113,113,113,
0,1,8,17,18,19,20,21,22,23,24,25,26,27,28,29,62,
0,1,10,36,64,80,81,82,83,84,122,123,154,161,161,161,161,
0,1,10,33,34,35,36,37,38,39,40,41,42,45,58,58,58,
0,1,13,34,68,69,76,99,102,103,104,105,106,107,204,211,239,
0,1,10,27,55,81,90,91,92,93,94,95,96,97,98,124,142,
0,1,13,31,40,41,42,43,44,45,46,47,48,49,50,136,147,
0,1,10,33,54,66,67,68,69,70,71,72,73,74,80,81,135,
0,1,8,28,53,63,64,65,66,67,68,69,70,71,71,71,71,
0,1,10,16,17,18,19,20,21,22,44,45,87,87,87,87,87,
0,1,8,32,39,40,41,42,43,79,80,81,82,86,100,100,100,
0,1,8,12,13,14,15,16,17,18,19,20,21,22,23,53,53,
0,1,8,33,51,51,51,51,51,51,51,51,51,51,51,51,51,
0,1,9,32,52,71,71,71,71,71,71,71,71,71,71,71,71,
0,1,10,34,55,60,61,62,63,64,65,66,78,86,93,107,124,
0,1,8,15,16,17,18,19,20,21,22,61,80,86,86,86,86,
0,1,11,27,27,27,27,27,27,27,27,27,27,27,27,27,27,
0,1,6,17,17,17,17,17,17,17,17,17,17,17,17,17,17,
0,1,9,31,60,79,80,81,82,108,147,147,147,147,147,147,147,
0,1,9,28,51,78,79,80,81,82,83,84,85,86,87,88,113,
0,1,9,28,28,28,28,28,28,28,28,28,28,28,28,28,28,
0,1,11,33,50,55,56,57,58,59,60,61,62,63,64,84,84,
0,1,8,36,57,86,86,86,86,86,86,86,86,86,86,86,86,
0,1,10,33,55,65,66,67,68,69,70,90,90,90,90,90,90,
0,1,8,23,24,25,26,27,28,29,30,31,32,33,34,35,135,
0,1,8,29,49,52,53,54,58,59,60,64,65,87,87,87,87,
0,1,9,29,50,51,52,53,54,55,55,55,55,55,55,55,55,
0,1,10,32,39,40,41,42,43,44,45,46,67,68,69,70,76,
0,1,10,33,60,83,98,99,100,101,102,103,104,105,106,130,130,
0,1,11,30,31,32,33,34,35,36,37,38,39,40,60,60,60,
0,1,2,3,4,5,6,7,8,9,10,11,12,13,39,39,39,
0,1,3,4,5,19,48,49,50,51,52,52,52,52,52,52,52,
0,1,2,3,4,5,6,7,8,9,10,11,12,18,38,65,72,
0,1,10,33,55,56,57,58,59,60,61,62,63,64,65,66,77,
0,1,14,44,61,61,61,61,61,61,61,61,61,61,61,61,61,
0,1,8,32,40,40,40,40,40,40,40,40,40,40,40,40,40,
0,1,12,33,34,35,36,37,38,39,40,41,56,81,116,124,124,
0,1,12,14,14,14,14,14,14,14,14,14,14,14,14,14,14,
0,1,8,33,57,61,62,63,64,65,66,67,68,69,70,71,148,
0,1,8,17,18,19,20,20,20,20,20,20,20,20,20,20,20,
0,1,8,32,45,46,47,48,49,50,51,52,53,54,75,96,116,
0,1,8,40,51,52,53,54,55,56,57,58,59,60,61,72,92,
0,1,2,3,4,5,6,7,13,48,48,48,48,48,48,48,48,
0,1,10,30,35,36,37,38,39,40,41,42,43,44,45,46,84,
0,1,9,18,19,20,21,22,23,24,25,29,30,31,32,37,153,
0,1,10,38,50,79,79,79,79,79,79,79,79,79,79,79,79,
0,1,6,7,8,9,10,11,12,13,14,15,16,17,18,35,58,
0,1,10,23,23,23,23,23,23,23,23,23,23,23,23,23,23,
0,1,9,30,59,82,83,84,85,86,87,88,184,206,230,230,230,
0,1,8,32,32,32,32,32,32,32,32,32,32,32,32,32,32,
0,1,12,19,20,21,22,23,24,25,26,27,28,29,30,31,167,
0,1,9,32,50,51,52,53,54,55,56,57,58,59,60,61,67,
0,1,10,11,12,13,14,15,16,17,18,29,30,31,32,67,67,
0,1,8,15,15,15,15,15,15,15,15,15,15,15,15,15,15,
0,1,11,30,57,83,103,104,105,106,107,108,120,144,145,146,161,
0,1,7,25,41,42,43,44,45,46,47,48,49,50,51,123,123,
0,1,11,38,67,68,69,70,71,72,73,83,83,83,83,83,83,
0,1,9,27,28,29,30,31,35,36,37,38,39,40,41,42,42,
0,1,7,7,7,7,7,7,7,7,7,7,7,7,7,7,7,
0,1,8,13,14,15,16,22,53,54,55,56,90,91,92,93,93,
0,1,8,30,53,53,53,53,53,53,53,53,53,53,53,53,53,
0,0,0,0,0,0,0,0,0,0,0,0,0,0,0,0,0,
0,1,6,7,8,9,10,11,12,13,14,15,24,25,59,81,106,
0,1,2,3,4,5,6,7,8,9,10,62,63,64,112,131,131,
0,1,7,9,9,9,9,9,9,9,9,9,9,9,9,9,9,
0,1,7,27,33,33,33,33,33,33,33,33,33,33,33,33,33,
0,1,6,7,8,18,47,48,49,50,62,62,62,62,62,62,62,
0,1,10,12,13,14,17,35,42,43,44,45,46,47,56,82,107,
0,1,9,31,
0,1,11,31,56,80,81,82,83,84,85,86,87,93,120,140,156,
0,1,6,20,21,22,23,24,25,53,79,81,81,81,81,81,81,
0,1,10,42,46,47,48,49,50,51,52,53,54,55,56,80,82,
0,1,7,17,17,17,17,17,17,17,17,17,17,17,17,17,17,
0,1,10,29,49,50,51,52,53,54,55,56,57,58,59,60,65,
0,1,9,14,15,16,17,18,19,20,21,22,23,24,25,48,48,
0,1,2,3,4,5,6,7,8,9,38,38,38,38,38,38,38,
0,1,8,31,54,55,56,57,58,59,60,61,62,63,64,65,124,
0,1,9,12,13,14,15,16,84,85,86,102,104,105,124,124,124,
0,1,11,32,59,81,106,132,138,138,138,138,138,138,138,138,138,
0,1,2,3,4,5,6,7,21,39,44,45,46,47,48,65,65,
0,1,8,15,16,17,18,19,20,21,22,23,24,25,36,37,45,
0,1,
0,1,10,31,36,37,38,39,40,41,42,167,168,169,173,173,173,
0,1,9,35,55,70,71,72,73,74,75,76,94,95,118,123,126,
0,1,9,26,52,70,70,70,70,70,70,70,70,70,70,70,70,
0,1,10,33,47,63,64,65,66,67,68,69,70,71,72,73,124,
0,1,9,19,20,21,22,23,24,34,59,59,59,59,59,59,59,
0,1,10,30,43,44,45,46,47,48,49,50,51,52,53,54,78,
0,1,6,26,53,66,66,66,66,66,66,66,66,66,66,66,66,
0,1,9,28,29,30,31,32,33,34,35,36,37,38,39,40,68,
0,1,7,9,10,11,12,13,14,17,26,26,26,26,26,26,26,
0,1,2,3,4,5,6,7,8,9,10,11,12,13,14,15,51,
0,1,10,32,62,73,74,75,76,77,78,79,80,81,176,188,217,
0,1,10,26,53,71,72,73,74,75,76,86,103,103,103,103,103,
0,1,10,17,18,19,20,21,22,23,41,42,43,44,47,47,47,
0,1,10,19,20,21,22,22,22,22,22,22,22,22,22,22,22,
0,1,10,33,57,88,109,138,163,188,222,233,233,233,233,233,233,
0,1,8,8,8,8,8,8,8,8,8,8,8,8,8,8,8,
0,1,10,36,57,77,78,79,80,81,82,83,84,150,150,150,150,
0,1,9,30,30,30,30,30,30,30,30,30,30,30,30,30,30,
0,1,10,22,23,24,25,26,43,43,43,43,43,43,43,43,43,
