author:	Mlewandowska
date:	2019-09-07 23:00	2019-09-08 01:13
concentration = 0.15, size: 300x300
distribution: Gauss	scale: 1.0
init_number_X = 50, init_number_Y = 13500	n_links = 90
k1 = 1, k2 = 1, beta = 0, lambd = 1.0
number of simulations k = 25, number of iterations n = 1000
range sampling: [0, 5, 10, 20, 30, 40, 50, 60, 70, 80, 90, 100, 110, 120, 130, 140, 150]

0,1,8,9,10,11,12,13,14,15,16,17,18,19,27,40,40,
0,1,8,23,25,26,27,28,29,30,31,41,44,45,46,47,60,
0,1,6,23,23,23,23,23,23,23,23,23,23,23,23,23,23,
0,1,6,21,22,23,24,25,26,27,28,29,45,45,45,45,45,
0,1,8,22,37,38,39,40,41,54,54,54,54,54,54,54,54,
0,1,7,14,15,16,17,18,19,20,21,22,23,24,25,26,64,
0,1,6,19,22,23,24,25,26,27,28,29,30,31,32,33,48,
0,1,6,13,13,13,13,13,13,13,13,13,13,13,13,13,13,
0,1,7,22,30,31,32,33,34,35,36,37,38,38,38,38,38,
0,1,6,7,8,9,10,11,12,13,14,15,16,17,18,33,33,
0,1,7,22,36,53,55,55,55,55,55,55,55,55,55,55,55,
0,1,8,12,13,14,15,16,17,18,19,20,21,22,23,24,26,
0,1,9,26,38,39,40,41,42,43,44,45,46,65,70,88,88,
0,1,7,14,15,16,24,39,46,47,48,49,49,49,49,49,49,
0,1,9,23,40,57,60,61,62,63,63,63,63,63,63,63,63,
0,1,2,3,4,5,5,5,5,5,5,5,5,5,5,5,5,
0,1,7,12,13,14,15,16,17,18,19,20,21,22,23,23,23,
0,1,6,24,37,38,39,40,41,42,43,44,45,46,47,48,69,
0,1,6,12,13,14,15,23,24,25,26,27,28,29,30,31,52,
0,1,4,5,6,7,8,9,10,11,12,13,14,15,16,23,34,
0,1,2,3,4,5,6,7,8,9,10,11,12,13,14,15,23,
0,1,6,23,29,29,29,29,29,29,29,29,29,29,29,29,29,
0,1,2,2,2,2,2,2,2,2,2,2,2,2,2,2,2,
0,1,6,22,32,33,34,35,36,37,38,39,46,55,55,55,55,
0,1,8,21,22,23,24,25,26,27,28,29,30,31,54,71,82,
0,1,6,9,10,11,12,13,14,15,15,15,15,15,15,15,15,
0,1,4,5,6,7,8,9,10,11,12,13,22,23,24,37,46,
0,1,9,24,38,44,45,46,47,48,49,50,51,52,54,66,66,
0,1,1,1,1,1,1,1,1,1,1,1,1,1,1,1,1,
0,1,7,20,21,22,23,24,25,29,30,31,32,33,34,35,69,
0,1,7,25,36,37,38,39,40,41,42,43,44,45,46,47,53,
0,1,6,22,23,24,25,26,27,28,29,30,31,36,39,39,39,
0,1,7,13,14,15,16,17,18,19,20,21,22,23,64,64,64,
0,1,7,14,15,16,17,18,19,20,21,22,22,22,22,22,22,
0,1,5,19,22,23,24,25,26,27,28,29,30,31,33,51,57,
0,1,6,8,8,8,8,8,8,8,8,8,8,8,8,8,8,
0,1,6,25,26,26,26,26,26,26,26,26,26,26,26,26,26,
0,1,3,4,5,6,7,8,9,10,11,12,13,14,21,22,38,
0,1,6,19,35,37,38,39,39,39,39,39,39,39,39,39,39,
0,1,5,6,7,8,9,10,11,12,13,14,15,16,17,29,43,
0,1,7,17,18,20,20,20,20,20,20,20,20,20,20,20,20,
0,1,8,23,23,23,23,23,23,23,23,23,23,23,23,23,23,
0,1,7,20,21,22,23,24,25,26,27,28,29,30,31,32,34,
0,1,7,18,19,20,21,22,23,24,25,39,43,43,43,43,43,
0,1,6,6,6,6,6,6,6,6,6,6,6,6,6,6,6,
0,1,7,21,36,37,37,37,37,37,37,37,37,37,37,37,37,
0,1,8,13,14,15,16,17,18,19,20,21,22,23,41,44,44,
0,1,2,3,4,5,6,7,8,9,10,11,12,13,14,15,26,
0,1,8,25,31,32,33,34,35,35,35,35,35,35,35,35,35,
0,1,6,12,13,14,15,16,17,18,19,20,21,22,23,24,28,
0,1,6,22,28,29,30,31,32,33,34,35,36,37,52,52,52,
0,1,4,5,6,7,8,9,10,11,12,12,12,12,12,12,12,
0,1,7,12,13,14,15,16,17,18,19,20,28,32,33,34,34,
0,1,6,9,9,9,9,9,9,9,9,9,9,9,9,9,9,
0,1,4,5,6,7,8,9,10,11,12,13,14,17,32,34,34,
0,1,7,8,9,10,11,12,13,14,14,14,14,14,14,14,14,
0,1,6,19,26,27,28,29,30,31,32,43,44,45,46,47,57,
0,1,7,15,16,17,18,19,20,21,22,23,24,25,39,39,39,
0,1,2,3,4,5,6,13,19,20,21,22,23,24,38,48,51,
0,1,6,12,12,12,12,12,12,12,12,12,12,12,12,12,12,
0,1,3,3,3,3,3,3,3,3,3,3,3,3,3,3,3,
0,1,6,21,26,32,33,34,35,36,37,38,42,43,44,51,62,
0,1,7,15,15,15,15,15,15,15,15,15,15,15,15,15,15,
0,1,6,10,11,12,13,14,15,16,17,18,18,18,18,18,18,
0,1,6,6,6,6,6,6,6,6,6,6,6,6,6,6,6,
0,1,7,23,27,28,29,30,31,32,33,34,35,36,37,40,40,
0,1,6,7,7,7,7,7,7,7,7,7,7,7,7,7,7,
0,1,4,5,6,14,29,39,40,41,42,45,46,47,48,58,65,
0,1,7,23,40,41,42,43,44,45,46,47,48,49,50,78,78,
0,1,7,22,23,24,25,26,27,28,41,42,43,56,56,56,56,
0,1,7,22,25,26,27,27,27,27,27,27,27,27,27,27,27,
0,1,1,1,1,1,1,1,1,1,1,1,1,1,1,1,1,
0,1,7,16,17,18,19,20,26,30,31,32,33,34,35,36,44,
0,1,7,23,39,53,63,64,65,69,72,73,74,75,78,92,92,
0,1,7,19,24,25,26,26,26,26,26,26,26,26,26,26,26,
0,1,6,21,22,22,22,22,22,22,22,22,22,22,22,22,22,
0,1,7,15,16,17,18,19,20,21,22,35,36,37,38,41,53,
0,1,5,8,9,10,11,12,13,14,15,16,17,18,19,23,34,
0,1,6,8,8,8,8,8,8,8,8,8,8,8,8,8,8,
0,1,7,15,16,17,18,19,20,21,22,23,24,25,35,35,35,
0,1,9,23,31,32,33,34,34,34,34,34,34,34,34,34,34,
0,1,7,17,18,19,20,21,22,23,24,25,26,27,28,29,33,
0,1,7,13,14,15,16,17,23,24,25,26,27,28,36,37,75,
0,1,8,16,17,18,19,20,21,23,23,23,23,23,23,23,23,
0,1,4,5,6,7,8,9,10,11,12,13,14,15,15,15,15,
0,1,8,12,13,14,15,16,17,18,19,21,32,33,34,35,66,
0,1,7,20,24,25,26,27,28,29,30,31,32,35,35,35,35,
0,1,8,22,23,27,35,36,37,38,39,41,44,44,44,44,44,
0,1,8,14,14,14,14,14,14,14,14,14,14,14,14,14,14,
0,1,7,11,12,13,14,15,16,17,18,19,20,21,22,23,67,
0,1,6,15,16,17,18,19,20,21,22,23,24,25,26,27,47,
0,1,7,22,36,40,40,40,40,40,40,40,40,40,40,40,40,
0,1,2,3,4,5,6,6,6,6,6,6,6,6,6,6,6,
0,1,2,3,4,5,6,27,28,29,33,34,34,34,34,34,34,
0,1,6,20,34,42,43,44,45,46,47,48,49,50,51,52,54,
0,1,6,20,21,22,23,24,25,26,27,28,29,30,31,38,54,
0,1,2,3,4,5,6,7,8,19,29,29,29,29,29,29,29,
0,1,5,6,7,8,9,10,11,12,13,14,15,15,15,15,15,
0,1,7,21,37,37,37,37,37,37,37,37,37,37,37,37,37,
0,1,7,21,22,23,24,25,26,27,28,29,30,31,32,41,41,
0,1,6,13,14,15,16,17,18,26,27,28,36,54,54,54,54,
0,1,8,20,36,44,45,53,54,55,56,57,58,59,85,103,103,
0,1,6,23,23,23,23,23,23,23,23,23,23,23,23,23,23,
0,1,7,16,17,18,19,20,21,22,23,24,25,26,27,31,40,
0,1,7,23,25,25,25,25,25,25,25,25,25,25,25,25,25,
0,1,5,17,18,19,20,21,22,57,58,59,60,61,62,63,64,
0,1,6,19,19,19,19,19,19,19,19,19,19,19,19,19,19,
0,1,2,3,4,5,6,7,8,9,10,11,12,13,16,31,46,
0,1,2,3,4,5,6,7,8,9,10,11,12,13,14,15,21,
0,1,2,2,2,2,2,2,2,2,2,2,2,2,2,2,2,
0,1,6,13,14,15,16,17,18,19,20,21,22,23,24,45,47,
0,1,8,22,23,24,24,24,24,24,24,24,24,24,24,24,24,
0,1,7,19,19,19,19,19,19,19,19,19,19,19,19,19,19,
0,0,0,0,0,0,0,0,0,0,0,0,0,0,0,0,0,
0,1,7,8,9,19,20,21,22,23,24,25,26,36,47,48,55,
0,1,7,20,21,22,32,33,34,35,36,37,38,39,40,41,49,
0,1,6,9,10,11,12,13,14,15,16,17,18,19,20,21,29,
0,1,2,3,4,5,6,7,8,9,10,11,12,15,18,19,55,
0,1,6,24,30,31,32,33,34,35,36,37,38,39,40,57,57,
0,1,8,21,27,28,29,29,29,29,29,29,29,29,29,29,29,
0,1,2,3,4,5,6,7,8,9,10,11,12,13,26,30,30,
0,1,8,21,22,23,24,25,26,27,28,29,30,31,32,33,50,
0,1,4,5,6,7,8,9,10,11,12,13,13,13,13,13,13,
0,1,2,3,4,5,6,7,8,9,10,11,12,31,31,31,31,
0,1,7,19,20,21,22,23,23,23,23,23,23,23,23,23,23,
0,1,6,7,8,9,10,11,12,13,14,15,16,17,18,19,27,
0,1,5,6,7,8,15,16,17,18,18,18,18,18,18,18,18,
0,1,6,7,8,9,10,11,12,13,14,15,16,17,35,47,47,
0,1,6,17,18,19,20,21,22,23,24,25,26,27,28,29,29,
0,1,7,7,7,7,7,7,7,7,7,7,7,7,7,7,7,
0,1,2,3,4,5,6,7,8,9,10,11,12,13,36,36,36,
0,1,5,21,24,25,26,27,28,29,30,38,39,47,61,62,71,
0,1,6,14,15,16,17,18,19,20,21,22,23,24,35,35,35,
0,1,2,3,4,5,6,7,8,9,10,11,12,13,14,15,23,
0,1,2,3,4,5,6,7,8,9,10,11,46,47,48,66,73,
0,1,8,23,30,31,32,33,34,35,36,37,37,37,37,37,37,
0,1,9,12,13,14,15,53,58,59,60,61,62,63,64,64,64,
0,1,2,3,4,5,6,7,8,9,10,19,27,28,29,29,29,
0,1,8,22,23,24,31,32,33,34,35,36,37,38,39,41,41,
0,1,8,9,10,11,12,13,14,15,16,17,18,19,20,43,43,
0,1,7,21,32,33,34,35,36,37,38,39,40,41,42,43,54,
0,1,7,9,9,9,9,9,9,9,9,9,9,9,9,9,9,
0,1,6,8,9,10,11,17,18,19,20,21,22,23,24,35,35,
0,1,2,3,4,5,6,7,8,9,10,11,12,13,14,14,14,
0,1,5,9,10,11,12,13,14,15,16,17,18,19,20,32,50,
0,1,6,14,14,14,14,14,14,14,14,14,14,14,14,14,14,
0,1,5,6,7,8,9,10,11,29,30,31,32,33,34,35,59,
0,0,0,0,0,0,0,0,0,0,0,0,0,0,0,0,0,
0,1,6,7,8,9,10,11,12,13,14,15,16,17,18,19,37,
0,1,8,19,20,21,31,32,33,34,35,36,37,38,39,40,42,
0,1,5,20,25,26,27,28,29,30,31,32,33,34,35,73,80,
0,1,6,13,14,15,16,17,18,19,20,21,22,23,38,44,44,
0,1,8,22,34,39,40,41,42,43,44,45,46,47,55,77,80,
0,1,6,19,20,21,22,23,24,25,26,27,28,28,28,28,28,
0,1,4,5,6,7,8,9,10,11,12,13,14,15,16,17,20,
0,1,2,3,4,5,6,7,8,9,10,11,12,13,14,47,49,
0,1,7,21,22,23,24,25,26,27,28,29,30,31,32,33,37,
0,1,6,22,26,27,28,29,30,31,32,45,45,45,45,45,45,
0,1,6,24,32,33,34,35,36,37,38,39,40,42,54,55,62,
0,1,3,4,5,6,7,8,9,10,11,12,13,29,35,35,35,
0,1,6,7,8,9,10,11,12,13,14,15,16,42,43,47,65,
0,1,6,7,8,9,10,11,12,13,14,23,38,54,55,55,55,
0,1,6,23,27,28,29,30,31,32,33,34,35,36,37,38,47,
0,1,8,23,41,42,43,44,45,46,47,48,48,48,48,48,48,
0,1,6,22,23,24,25,26,34,35,36,37,38,39,40,41,54,
0,1,7,24,39,40,41,53,54,55,56,57,58,58,58,58,58,
0,1,7,23,32,45,59,60,61,62,63,64,65,66,79,93,110,
0,1,5,21,37,49,50,51,52,53,54,55,56,57,58,78,108,
0,1,7,17,18,19,20,21,22,23,24,25,26,27,28,29,37,
0,1,2,3,4,5,6,7,8,9,10,11,12,13,20,35,35,
0,1,7,15,16,17,18,19,20,21,23,23,23,23,23,23,23,
0,1,7,22,22,22,22,22,22,22,22,22,22,22,22,22,22,
0,1,9,21,22,23,24,25,26,27,28,29,30,31,32,40,59,
0,1,7,22,26,27,28,29,30,31,37,38,39,39,39,39,39,
0,1,8,23,26,27,28,29,30,35,38,39,40,41,42,42,42,
0,1,7,10,11,12,13,14,15,16,17,18,19,20,25,25,25,
0,1,2,3,4,5,6,7,8,9,10,19,20,21,26,26,26,
0,1,8,9,10,11,12,13,14,15,16,29,34,45,57,57,57,
0,1,7,22,38,45,45,45,45,45,45,45,45,45,45,45,45,
0,1,7,21,23,24,25,26,27,28,29,30,31,32,33,33,33,
0,1,2,2,2,2,2,2,2,2,2,2,2,2,2,2,2,
0,1,7,20,35,36,37,37,37,37,37,37,37,37,37,37,37,
0,1,6,12,13,14,15,16,17,18,19,20,21,22,23,24,74,
0,1,7,23,37,38,39,40,41,42,43,43,43,43,43,43,43,
0,1,7,8,9,10,11,12,13,14,15,16,17,18,19,20,20,
0,1,5,6,7,8,9,10,11,12,13,19,23,23,23,23,23,
0,1,7,9,10,11,12,13,14,15,16,27,28,29,30,31,38,
0,1,6,20,21,22,23,24,25,26,27,28,29,30,30,30,30,
0,1,6,20,28,29,30,31,32,39,40,41,42,43,44,47,47,
0,1,8,23,32,33,34,35,36,37,38,39,39,39,39,39,39,
0,1,7,10,11,12,13,14,15,29,30,31,32,33,34,35,49,
0,1,6,20,21,22,22,22,22,22,22,22,22,22,22,22,22,
0,1,5,5,5,5,5,5,5,5,5,5,5,5,5,5,5,
0,1,7,7,7,7,7,7,7,7,7,7,7,7,7,7,7,
0,1,2,3,4,5,6,7,8,9,10,11,12,13,14,27,33,
0,1,5,24,37,53,54,55,56,57,58,59,59,59,59,59,59,
0,1,6,22,23,24,25,26,27,28,29,30,31,49,61,66,70,
0,1,8,22,22,22,22,22,22,22,22,22,22,22,22,22,22,
0,1,8,23,31,31,31,31,31,31,31,31,31,31,31,31,31,
0,1,6,10,11,12,13,14,15,16,17,18,19,20,32,38,38,
0,1,6,23,34,35,36,37,38,39,40,41,42,43,44,45,72,
0,1,6,11,12,13,14,15,16,17,18,19,20,21,34,35,57,
0,1,4,5,6,7,8,9,10,11,12,13,14,15,16,26,46,
0,1,5,6,7,8,9,10,11,12,13,14,35,35,35,35,35,
0,1,7,23,24,25,26,27,28,29,30,31,32,33,48,48,48,
0,1,9,25,27,28,29,30,31,32,33,34,35,36,43,43,43,
0,1,3,4,5,6,7,7,7,7,7,7,7,7,7,7,7,
0,1,6,7,8,9,10,11,12,26,47,63,74,75,84,88,89,
0,1,7,12,13,14,15,16,17,18,19,20,21,22,23,37,52,
0,1,2,3,4,5,6,7,9,24,25,47,47,47,47,47,47,
0,1,7,20,38,39,40,41,42,42,42,42,42,42,42,42,42,
0,1,8,19,20,21,22,23,24,25,26,27,28,29,30,31,69,
0,1,7,17,17,17,17,17,17,17,17,17,17,17,17,17,17,
0,1,6,25,39,39,39,39,39,39,39,39,39,39,39,39,39,
0,1,2,3,4,5,6,7,8,9,10,11,28,29,30,35,35,
0,1,7,23,24,25,26,27,28,29,30,31,32,36,51,59,59,
0,1,7,20,21,22,23,24,25,26,27,28,29,30,76,76,76,
0,1,6,18,18,18,18,18,18,18,18,18,18,18,18,18,18,
0,1,7,20,35,36,37,38,39,40,41,42,43,44,44,44,44,
0,1,7,19,20,21,22,23,24,25,26,45,62,63,66,67,72,
0,1,7,8,8,8,8,8,8,8,8,8,8,8,8,8,8,
0,1,6,22,36,43,44,45,46,47,48,49,50,51,52,56,73,
0,1,7,11,12,13,14,15,16,17,18,28,41,42,43,44,76,
0,1,2,3,4,5,6,7,8,9,10,11,12,13,14,15,15,
0,1,3,4,5,6,7,8,9,10,11,12,13,14,15,16,29,
