author:	Mlewandowska
date:	2019-09-09 22:34	2019-09-10 00:21
concentration = 0.15, size: 300x300
distribution: Gauss	scale: 1.0
init_number_X = 50, init_number_Y = 13500	n_links = 9
k1 = 1, k2 = 1, beta = 0, lambd = 1.0
number of simulations k = 10, number of iterations n = 1000
range sampling: [0, 5, 10, 20, 30, 40, 50, 60, 70, 80, 90, 100, 110, 120, 130, 140, 150]

0,1,6,19,35,49,66,73,100,100,100,100,100,100,100,100,100,
0,1,7,23,38,40,41,42,43,44,45,108,109,141,142,159,177,
0,1,7,24,41,59,74,89,90,91,92,114,115,116,117,118,137,
0,1,8,24,40,43,44,45,46,47,48,49,50,58,65,65,65,
0,1,8,23,28,28,28,28,28,28,28,28,28,28,28,28,28,
0,1,5,20,32,45,60,76,92,110,126,133,134,135,174,174,174,
0,1,7,21,24,25,26,27,28,29,30,31,32,33,41,51,75,
0,1,8,23,37,38,39,40,41,43,65,80,106,115,121,127,127,
0,1,6,22,36,52,65,79,98,100,101,102,103,104,105,109,130,
0,1,6,21,37,55,67,68,69,70,71,72,73,91,92,93,103,
0,1,8,23,33,34,35,36,37,38,39,40,41,77,94,110,128,
0,1,7,10,11,12,13,14,15,16,17,18,19,20,22,38,53,
0,1,7,21,40,55,62,63,64,65,66,67,68,69,70,80,100,
0,1,7,22,38,55,70,81,81,81,81,81,81,81,81,81,81,
0,1,6,21,38,54,69,71,79,102,115,134,149,149,149,149,149,
0,1,7,22,36,37,38,39,40,41,42,43,44,45,57,73,73,
0,1,7,23,36,51,65,85,94,94,94,94,94,94,94,94,94,
0,1,7,23,35,36,37,38,39,40,41,42,44,61,83,95,95,
0,1,7,23,36,53,65,80,94,94,94,94,94,94,94,94,94,
0,1,7,23,41,56,72,88,88,88,88,88,88,88,88,88,88,
0,1,7,20,38,53,68,81,92,92,92,92,92,92,92,92,92,
0,1,6,22,39,54,69,84,102,117,132,149,155,156,161,178,198,
0,1,6,23,37,52,69,88,107,122,138,147,147,147,147,147,147,
0,1,8,24,26,26,26,26,26,26,26,26,26,26,26,26,26,
0,1,6,22,39,57,63,64,65,66,66,66,66,66,66,66,66,
0,1,7,22,36,51,72,86,100,114,114,114,114,114,114,114,114,
0,1,8,23,33,33,33,33,33,33,33,33,33,33,33,33,33,
0,1,7,26,44,58,74,88,101,117,118,118,118,118,118,118,118,
0,1,6,21,39,53,67,80,81,82,83,84,85,86,87,88,196,
0,1,7,23,37,53,66,66,66,66,66,66,66,66,66,66,66,
0,1,6,22,38,53,68,74,75,76,77,78,95,111,113,114,125,
0,1,3,4,5,6,7,8,9,10,11,12,13,14,15,16,17,
0,1,7,16,17,18,19,20,21,22,23,24,24,24,24,24,24,
0,1,6,25,35,36,37,38,39,40,41,42,43,44,45,59,80,
0,1,8,22,39,53,68,85,92,116,132,145,147,164,186,190,190,
0,1,7,21,37,57,73,74,75,76,77,78,79,89,96,97,102,
0,1,6,15,15,15,15,15,15,15,15,15,15,15,15,15,15,
0,1,8,23,39,56,71,79,80,81,82,83,84,107,122,136,152,
0,1,6,21,36,55,69,84,97,97,97,97,97,97,97,97,97,
0,1,5,24,40,56,72,79,80,81,82,83,84,85,86,145,145,
0,1,7,23,39,55,70,79,80,81,82,83,84,84,84,84,84,
0,1,6,20,35,48,49,50,51,52,53,54,55,56,57,58,80,
0,1,7,20,33,48,71,86,102,124,128,128,128,128,128,128,128,
0,1,6,25,29,30,31,32,33,34,35,36,37,45,64,78,94,
0,1,6,19,33,35,36,37,38,39,40,42,62,78,86,86,86,
0,1,7,23,40,53,54,55,56,60,61,62,78,79,80,81,93,
0,1,6,7,8,9,10,11,12,13,14,15,16,17,28,43,58,
0,1,6,23,40,53,54,55,56,120,135,148,148,148,148,148,148,
0,1,7,21,35,35,35,35,35,35,35,35,35,35,35,35,35,
0,1,6,22,36,52,67,82,97,98,99,100,101,102,106,135,151,
0,1,7,23,40,55,64,65,66,67,68,69,70,71,101,105,114,
0,1,6,20,36,50,69,85,85,85,85,85,85,85,85,85,85,
0,1,6,21,36,53,71,72,73,74,75,76,77,78,79,84,104,
0,1,8,23,39,53,67,84,101,104,105,106,107,108,109,111,157,
0,1,6,23,38,55,71,86,101,116,122,122,122,122,122,122,122,
0,1,6,20,37,42,42,42,42,42,42,42,42,42,42,42,42,
0,1,7,23,38,56,75,84,85,86,87,88,102,106,106,106,106,
0,1,5,21,34,35,36,37,38,39,44,65,86,102,112,113,128,
0,1,7,22,38,44,44,44,44,44,44,44,44,44,44,44,44,
0,1,6,15,16,17,18,19,20,21,22,23,24,25,26,27,31,
0,1,6,22,37,49,66,81,86,86,86,86,86,86,86,86,86,
0,1,8,23,41,57,60,61,62,63,81,81,81,81,81,81,81,
0,1,7,23,38,46,47,48,63,73,74,91,108,111,112,127,127,
0,1,8,22,37,55,57,58,59,60,61,62,64,65,66,138,145,
0,1,7,21,36,50,69,81,82,83,84,85,86,87,88,89,126,
0,1,6,22,37,52,68,83,100,101,102,103,104,105,143,158,172,
0,1,7,21,38,54,70,87,100,101,102,103,104,105,106,171,172,
0,1,7,22,38,45,45,45,45,45,45,45,45,45,45,45,45,
0,1,8,21,39,56,71,86,101,116,117,118,119,120,121,127,142,
0,1,7,22,37,51,54,54,54,54,54,54,54,54,54,54,54,
0,1,5,11,12,13,14,15,16,17,18,19,20,21,22,23,43,
0,1,7,22,41,56,61,62,63,64,65,66,67,130,131,132,139,
0,1,6,19,41,55,69,86,103,110,111,112,145,145,145,145,145,
0,1,7,25,37,41,41,41,41,41,41,41,41,41,41,41,41,
0,1,7,22,35,52,66,74,74,74,74,74,74,74,74,74,74,
0,1,7,21,36,50,66,68,69,70,71,72,73,74,75,76,87,
0,1,6,27,43,61,77,94,109,111,111,111,111,111,111,111,111,
0,1,7,26,43,44,45,46,46,46,46,46,46,46,46,46,46,
0,1,8,22,40,58,63,63,63,63,63,63,63,63,63,63,63,
0,1,8,24,40,54,55,62,77,93,110,130,138,138,138,138,138,
0,1,6,22,37,51,69,87,99,115,116,117,118,119,120,121,131,
0,1,7,21,37,51,69,78,79,80,100,101,102,102,102,102,102,
0,1,7,22,36,51,67,85,102,113,114,117,137,153,168,174,184,
0,1,6,23,39,55,70,83,84,85,86,87,97,103,115,115,115,
0,1,6,22,38,51,59,60,61,62,63,64,65,66,67,79,97,
0,1,7,23,38,53,67,75,76,77,78,79,80,81,82,105,105,
0,1,7,23,40,56,72,80,80,80,80,80,80,80,80,80,80,
0,1,7,24,38,53,67,82,102,110,133,149,164,180,194,210,229,
0,1,7,21,33,44,45,46,47,48,49,50,51,52,53,54,65,
0,1,6,23,39,56,72,86,103,119,136,148,148,148,148,148,148,
0,1,5,19,34,51,67,86,96,97,98,99,100,101,102,122,192,
0,1,7,22,40,53,73,74,75,76,77,78,85,106,112,112,112,
0,1,7,22,23,24,25,26,27,28,29,30,31,32,33,49,49,
0,1,7,23,39,55,73,90,106,121,135,135,135,135,135,135,135,
0,1,8,24,39,56,72,88,104,121,135,152,153,154,155,216,234,
0,1,8,21,34,35,36,37,38,39,40,41,57,77,100,109,119,
0,1,6,21,36,59,74,85,85,85,85,85,85,85,85,85,85,
0,1,7,21,40,55,63,64,65,66,67,68,69,70,71,72,89,
0,1,7,23,37,38,39,40,41,42,43,44,48,48,48,48,48,
0,1,3,4,5,6,7,8,67,68,69,81,100,116,133,150,161,
0,1,6,21,36,54,60,60,60,60,60,60,60,60,60,60,60,
0,1,7,22,39,55,70,82,83,84,85,86,87,88,89,89,89,
0,1,7,23,37,52,68,84,100,113,127,142,153,154,155,156,163,
0,1,7,24,40,56,71,89,107,117,118,119,120,121,126,144,160,
0,1,8,25,44,60,74,92,101,102,103,104,105,106,108,128,149,
0,1,7,22,38,52,66,77,81,98,115,130,143,143,143,143,143,
0,1,8,24,40,58,73,91,104,117,118,119,120,176,176,176,176,
0,1,8,22,36,54,55,56,57,58,59,60,61,62,67,83,98,
0,1,6,22,36,53,66,76,77,78,83,101,117,117,117,117,117,
0,1,6,21,35,35,35,35,35,35,35,35,35,35,35,35,35,
0,1,6,21,37,54,68,88,91,92,93,104,119,135,150,165,181,
0,1,6,23,40,56,74,85,85,85,85,85,85,85,85,85,85,
0,1,7,23,40,54,63,64,65,66,67,68,74,90,109,128,151,
0,1,7,22,34,41,49,63,75,76,77,90,106,119,120,122,149,
0,1,6,24,39,55,56,57,58,59,60,61,62,63,64,66,84,
0,1,6,21,35,53,54,55,56,57,58,59,60,61,62,63,75,
0,1,7,23,42,57,72,86,106,120,121,122,123,124,125,139,154,
0,1,6,23,37,53,67,81,86,87,88,89,90,91,99,122,146,
0,1,7,16,17,18,19,20,21,22,23,24,25,26,27,33,49,
0,1,8,23,38,55,57,58,59,60,61,62,63,64,121,137,152,
0,1,6,23,37,54,63,63,63,63,63,63,63,63,63,63,63,
0,1,7,23,43,57,73,89,92,92,92,92,92,92,92,92,92,
0,1,5,19,34,48,49,50,51,52,56,56,56,56,56,56,56,
0,1,6,20,35,51,66,79,80,81,82,83,84,85,92,107,137,
0,1,8,21,40,57,74,89,103,110,111,112,113,114,115,131,148,
0,1,6,21,32,46,46,46,46,46,46,46,46,46,46,46,46,
0,1,6,19,36,52,70,84,99,115,116,127,146,161,174,190,190,
0,1,6,20,21,22,23,24,25,26,27,28,29,30,56,71,78,
0,1,7,20,36,51,72,85,100,104,105,106,107,108,109,116,148,
0,1,6,24,39,54,61,62,63,64,65,66,67,68,68,68,68,
0,1,6,22,39,55,71,77,78,79,80,81,98,112,130,148,163,
0,1,6,23,40,54,68,84,91,103,110,111,112,113,117,118,137,
0,1,6,22,32,33,34,35,36,37,38,39,49,58,59,60,118,
0,1,8,22,38,51,67,74,75,76,77,81,83,92,108,123,144,
0,1,8,23,28,29,30,31,32,33,34,35,36,37,45,65,85,
0,1,8,23,41,57,73,87,101,121,137,155,162,170,171,172,193,
0,1,5,6,7,8,9,10,11,12,13,62,77,94,110,124,141,
0,1,6,19,36,53,55,56,57,58,59,60,61,62,63,64,70,
0,1,8,24,37,54,67,68,69,70,71,72,73,74,75,76,102,
0,1,6,21,37,52,69,85,100,110,111,112,113,114,115,116,136,
0,1,6,21,22,23,24,25,26,27,28,29,30,31,32,33,48,
0,1,7,17,17,17,17,17,17,17,17,17,17,17,17,17,17,
0,1,7,23,41,59,75,91,106,124,141,148,148,148,148,148,148,
0,1,7,24,44,47,48,49,50,51,52,53,54,55,56,64,85,
0,1,7,19,35,50,51,52,53,54,59,82,99,103,103,103,103,
0,1,6,20,36,53,70,86,96,97,98,99,100,100,100,100,100,
0,1,7,23,30,31,32,33,34,35,36,37,38,39,40,111,111,
0,1,7,24,39,52,67,75,76,77,78,79,80,81,174,175,178,
0,1,7,24,42,59,74,92,107,122,139,141,141,141,141,141,141,
0,1,7,25,39,55,72,76,76,76,76,76,76,76,76,76,76,
0,1,8,24,41,58,72,76,77,78,79,80,81,82,83,84,94,
0,1,7,19,39,53,68,89,106,107,108,109,110,111,112,113,113,
0,1,7,23,41,56,74,84,85,86,87,88,89,90,100,119,133,
0,1,6,21,34,53,67,74,75,76,77,78,79,132,132,132,132,
0,1,9,21,35,49,67,83,84,84,84,84,84,84,84,84,84,
0,1,7,22,38,55,72,88,90,91,92,93,94,95,109,126,149,
0,1,8,24,40,57,72,88,101,121,121,121,121,121,121,121,121,
0,1,9,24,39,55,72,87,102,121,139,154,170,186,201,202,208,
0,1,7,22,37,53,53,53,53,53,53,53,53,53,53,53,53,
0,1,7,21,36,44,45,46,47,48,49,125,125,125,125,125,125,
0,1,7,22,37,54,70,86,91,92,93,94,95,96,97,98,98,
0,1,7,24,28,29,30,31,32,33,34,35,36,37,38,53,72,
0,1,6,21,34,52,69,71,71,71,71,71,71,71,71,71,71,
0,1,8,21,22,23,24,25,26,27,40,41,42,43,44,58,73,
0,1,8,24,40,57,73,77,78,79,80,81,82,83,84,85,85,
0,1,7,23,37,55,73,90,92,92,92,92,92,92,92,92,92,
0,1,8,24,39,53,71,89,104,117,118,119,135,153,173,189,190,
0,1,9,25,41,54,72,82,83,84,85,86,87,88,90,97,116,
0,1,7,23,36,51,72,78,79,80,81,82,83,84,85,97,133,
0,1,7,22,33,34,35,36,37,38,39,40,41,42,43,49,64,
0,1,6,14,15,16,17,18,19,20,21,22,23,24,25,26,137,
0,1,6,25,42,59,60,61,62,63,64,66,82,96,112,129,147,
0,1,1,1,1,1,1,1,1,1,1,1,1,1,1,1,1,
0,1,6,23,38,55,68,86,98,99,100,113,129,149,166,167,167,
0,1,9,22,40,58,74,88,104,117,119,120,121,131,135,135,135,
0,1,9,25,41,58,73,90,110,125,146,164,174,174,174,174,174,
0,1,7,20,36,51,67,81,94,95,96,97,98,99,100,114,132,
0,1,6,20,37,53,67,68,69,70,71,72,72,72,72,72,72,
0,1,8,22,34,35,36,37,38,39,40,41,42,130,130,130,130,
0,1,8,20,21,22,23,24,41,67,82,97,113,135,151,152,152,
0,1,6,15,16,17,18,19,20,21,37,59,77,78,79,80,98,
0,1,6,22,35,36,37,38,39,40,41,42,43,44,51,64,78,
0,1,6,21,38,52,62,63,64,65,66,67,68,69,72,72,72,
0,1,8,22,23,24,25,26,27,28,29,30,31,32,44,60,75,
0,1,7,20,34,48,65,82,100,114,124,125,126,127,128,129,163,
0,1,6,21,33,34,35,36,45,64,79,95,108,122,140,157,174,
0,1,7,20,34,50,66,67,68,69,101,102,103,104,115,132,149,
0,1,7,22,39,45,45,45,45,45,45,45,45,45,45,45,45,
0,1,8,24,40,56,70,85,101,116,128,139,139,139,139,139,139,
0,1,7,23,38,54,71,86,102,116,130,144,160,174,185,185,185,
0,1,7,25,40,58,75,92,108,122,138,153,168,184,186,213,222,
0,1,7,18,19,20,21,22,23,24,25,26,27,28,49,49,49,
0,1,7,21,39,54,73,90,108,122,134,135,136,137,138,150,150,
0,1,6,24,36,53,65,82,96,105,105,105,105,105,105,105,105,
0,1,2,3,4,5,6,7,8,9,10,11,14,15,141,157,175,
0,1,7,21,40,56,63,64,65,68,90,106,122,122,122,122,122,
0,1,6,23,33,34,35,36,104,115,116,117,118,119,120,120,120,
0,1,7,25,42,59,75,78,79,105,106,107,108,109,110,138,153,
0,1,8,23,38,56,73,87,102,120,133,134,135,136,165,182,199,
0,1,5,23,37,39,40,41,42,43,44,45,46,47,48,52,61,
0,1,6,24,39,60,76,87,109,124,141,151,161,175,187,187,187,
0,1,7,21,36,50,51,52,53,54,134,147,148,149,153,159,175,
0,1,8,23,39,53,73,79,80,81,82,83,84,85,90,107,124,
0,1,6,25,41,57,71,80,80,80,80,80,80,80,80,80,80,
0,1,8,22,40,56,73,75,76,77,78,79,80,81,110,123,123,
0,1,5,5,5,5,5,5,5,5,5,5,5,5,5,5,5,
0,1,6,21,29,30,31,32,37,55,59,60,61,62,63,64,82,
0,1,5,22,35,57,74,92,105,106,107,108,109,110,115,132,147,
0,1,7,23,40,56,73,89,105,120,137,153,167,177,177,177,177,
0,1,7,23,41,56,69,90,108,123,140,145,150,167,183,202,225,
0,1,8,24,40,57,72,77,78,117,133,143,144,158,159,193,207,
0,1,7,13,14,15,16,17,18,19,20,21,22,23,24,188,214,
0,1,7,19,36,52,68,79,80,81,82,83,84,85,86,106,124,
0,1,6,22,39,53,66,67,68,69,93,94,95,96,115,131,146,
0,1,7,24,41,59,76,87,88,89,90,91,100,110,127,133,133,
0,1,8,21,37,51,69,69,69,69,69,69,69,69,69,69,69,
0,1,6,22,36,50,68,84,99,116,131,139,139,139,139,139,139,
0,1,8,23,38,53,54,55,56,57,58,59,68,84,99,118,134,
0,1,7,25,41,55,74,87,88,94,95,96,97,98,99,114,129,
0,1,7,23,36,54,69,83,85,86,87,88,89,90,91,92,94,
0,1,8,24,40,56,65,66,67,68,69,70,84,109,125,145,160,
0,1,8,24,43,58,72,73,74,75,76,77,78,79,80,89,111,
0,1,8,22,39,55,70,83,85,86,87,88,89,90,91,92,109,
0,1,6,22,34,35,36,37,38,39,40,41,42,43,44,46,63,
0,1,9,25,37,57,69,70,102,110,110,110,110,110,110,110,110,
0,1,6,20,21,22,23,24,25,26,27,28,29,51,66,80,80,
0,1,9,22,33,33,33,33,33,33,33,33,33,33,33,33,33,
0,1,7,22,37,52,64,86,103,112,113,114,115,116,117,118,196,
0,1,6,23,38,54,70,86,95,96,97,98,99,100,107,108,159,
0,1,7,25,42,57,73,89,94,95,96,97,98,99,136,147,158,
0,1,6,23,38,53,68,79,80,81,82,83,84,85,86,87,204,
0,1,8,23,38,55,69,84,94,94,94,94,94,94,94,94,94,
0,1,5,24,40,42,42,42,42,42,42,42,42,42,42,42,42,
0,1,8,23,39,56,72,87,99,99,99,99,99,99,99,99,99,
0,1,7,23,38,53,71,74,75,76,77,78,79,80,81,82,83,
0,1,7,22,35,54,58,87,92,93,99,112,113,116,136,158,158,
0,1,8,24,31,32,33,34,53,65,80,87,95,95,95,95,95,
0,1,7,23,38,47,48,49,50,51,112,112,112,112,112,112,112,
0,1,8,24,39,51,68,81,97,119,133,156,172,173,197,219,235,
0,1,7,21,39,59,75,89,90,91,92,95,95,95,95,95,95,
0,1,7,20,33,46,47,48,54,69,84,101,107,108,109,110,113,
0,1,6,20,34,50,65,66,67,68,69,70,71,72,73,74,92,
0,1,7,22,39,54,71,84,105,105,105,105,105,105,105,105,105,
0,1,7,22,38,55,69,81,81,81,81,81,81,81,81,81,81,
0,1,6,24,37,53,68,84,86,87,88,89,90,91,92,93,121,
0,1,6,21,38,55,69,87,102,103,104,105,106,107,151,152,161,
0,1,6,23,37,54,70,85,100,113,128,144,144,144,144,144,144,
0,1,8,22,38,51,67,82,101,115,115,115,115,115,115,115,115,
0,1,6,23,39,57,75,89,107,122,138,146,146,146,146,146,146,
0,1,8,23,37,52,69,85,91,108,130,149,162,166,167,174,201,
0,1,7,22,37,52,69,71,72,73,74,75,76,77,78,79,91,
0,1,8,26,40,53,54,55,56,62,77,98,113,114,115,159,176,
0,1,8,24,39,54,54,54,54,54,54,54,54,54,54,54,54,
0,1,9,25,41,56,76,90,91,101,101,101,101,101,101,101,101,
0,1,6,25,38,54,68,77,78,79,80,81,83,83,83,83,83,
0,1,7,23,39,55,70,86,99,115,115,115,115,115,115,115,115,
0,1,7,22,38,48,49,50,51,52,53,54,78,78,78,78,78,
0,1,6,10,11,12,13,14,15,16,23,40,55,72,72,72,72,
0,1,7,9,10,11,12,13,14,15,16,17,18,19,29,48,65,
0,1,6,23,38,42,42,42,42,42,42,42,42,42,42,42,42,
