author:	Mlewandowska
date:	2019-09-04 22:55	2019-09-05 07:34
concentration = 0.2, size: 300x300
distribution: Gauss	scale: 1.0
init_number_X = 50, init_number_Y = 18000	n_links = 1800
k1 = 1, k2 = 1, beta = 0, lambd = 0.7
number of simulations k = 150, number of iterations n = 1000
range sampling: [0, 5, 10, 20, 30, 40, 50, 60, 70, 80, 90, 100, 110, 120, 130, 140, 150]

0,1,2,3,4,5,6,6,6,6,6,6,6,6,6,6,6,
0,1,2,3,4,5,6,7,13,14,15,16,17,18,19,20,36,
0,1,4,4,4,4,4,4,4,4,4,4,4,4,4,4,4,
0,1,2,3,4,5,6,7,8,9,10,11,12,13,14,15,37,
0,1,2,3,4,5,6,7,8,9,9,9,9,9,9,9,9,
0,0,0,0,0,0,0,0,0,0,0,0,0,0,0,0,0,
0,1,1,1,1,1,1,1,1,1,1,1,1,1,1,1,1,
0,1,2,3,3,3,3,3,3,3,3,3,3,3,3,3,3,
0,1,2,3,4,5,6,7,8,9,10,11,12,13,26,27,28,
0,0,0,0,0,0,0,0,0,0,0,0,0,0,0,0,0,
0,1,2,3,4,5,6,7,8,9,10,11,12,15,16,17,
0,1,8,10,11,12,13,14,18,26,26,26,26,26,26,26,26,
0,1,2,3,3,3,3,3,3,3,3,3,3,3,3,3,3,
0,0,0,0,0,0,0,0,0,0,0,0,0,0,0,0,0,
0,1,1,1,1,1,1,1,1,1,1,1,1,1,1,1,1,
0,0,0,0,0,0,0,0,0,0,0,0,0,0,0,0,0,
0,0,0,0,0,0,0,0,0,0,0,0,0,0,0,0,0,
0,1,2,2,2,2,2,2,2,2,2,2,2,2,2,2,2,
0,1,2,3,4,5,6,6,6,6,6,6,6,6,6,6,6,
0,1,2,2,2,2,2,2,2,2,2,2,2,2,2,2,2,
0,1,1,1,1,1,1,1,1,1,1,1,1,1,1,1,1,
0,1,2,3,4,5,6,7,8,9,10,11,12,13,13,13,13,
0,1,2,3,3,3,3,3,3,3,3,3,3,3,3,3,3,
0,1,2,3,4,5,6,7,8,9,10,10,10,10,10,10,10,
0,1,1,1,1,1,1,1,1,1,1,1,1,1,1,1,1,
0,1,1,1,1,1,1,1,1,1,1,1,1,1,1,1,1,
0,0,0,0,0,0,0,0,0,0,0,0,0,0,0,0,0,
0,1,2,3,4,5,6,7,8,8,8,8,8,8,8,8,8,
0,1,2,3,4,5,6,7,8,9,10,11,12,13,14,59,59,
0,1,3,4,5,6,6,6,6,6,6,6,6,6,6,6,6,
0,1,1,1,1,1,1,1,1,1,1,1,1,1,1,1,1,
0,0,0,0,0,0,0,0,0,0,0,0,0,0,0,0,0,
0,1,2,3,4,5,6,7,8,9,10,10,10,10,10,10,10,
0,1,4,4,4,4,4,4,4,4,4,4,4,4,4,4,4,
0,1,1,1,1,1,1,1,1,1,1,1,1,1,1,1,1,
0,1,1,1,1,1,1,1,1,1,1,1,1,1,1,1,1,
0,1,2,2,2,2,2,2,2,2,2,2,2,2,2,2,2,
0,1,2,3,4,5,6,7,8,9,10,11,12,13,14,15,24,
0,0,0,0,0,0,0,0,0,0,0,0,0,0,0,0,0,
0,1,2,3,4,5,6,6,6,6,6,6,6,6,6,6,6,
0,1,2,3,4,5,6,7,8,8,8,8,8,8,8,8,8,
0,1,2,2,2,2,2,2,2,2,2,2,2,2,2,2,2,
0,1,2,3,3,3,3,3,3,3,3,3,3,3,3,3,3,
0,1,2,3,4,5,6,7,7,7,7,7,7,7,7,7,7,
0,1,1,1,1,1,1,1,1,1,1,1,1,1,1,1,1,
0,1,2,3,4,5,6,7,8,9,10,11,12,13,14,35,44,
0,1,2,3,4,5,6,7,8,9,10,11,12,31,32,33,44,
0,1,1,1,1,1,1,1,1,1,1,1,1,1,1,1,1,
0,1,1,1,1,1,1,1,1,1,1,1,1,1,1,1,1,
0,1,2,3,4,5,6,7,8,9,10,11,12,13,14,15,43,
0,1,1,1,1,1,1,1,1,1,1,1,1,1,1,1,1,
0,1,2,3,4,5,6,7,8,9,10,11,12,13,15,15,15,
0,1,10,10,10,10,10,10,10,10,10,10,10,10,10,10,10,
0,1,2,3,4,5,6,7,8,9,10,11,12,13,14,15,15,
0,1,2,3,4,5,6,7,8,9,10,12,12,12,12,12,12,
0,1,2,3,4,5,6,7,8,9,10,11,12,13,23,24,42,
0,0,0,0,0,0,0,0,0,0,0,0,0,0,0,0,0,
0,1,2,3,4,5,6,7,8,9,9,9,9,9,9,9,9,
0,1,2,3,4,5,6,7,7,7,7,7,7,7,7,7,7,
0,1,1,1,1,1,1,1,1,1,1,1,1,1,1,1,1,
0,1,2,3,4,4,4,4,4,4,4,4,4,4,4,4,4,
0,1,2,3,4,5,6,7,8,9,10,11,12,13,14,15,15,
0,1,2,3,4,5,6,7,8,9,10,11,12,12,12,12,12,
0,1,1,1,1,1,1,1,1,1,1,1,1,1,1,1,1,
0,0,0,0,0,0,0,0,0,0,0,0,0,0,0,0,0,
0,1,2,2,2,2,2,2,2,2,2,2,2,2,2,2,2,
0,1,1,1,1,1,1,1,1,1,1,1,1,1,1,1,1,
0,1,8,9,10,11,12,13,14,15,16,17,18,19,20,21,24,
0,0,0,0,0,0,0,0,0,0,0,0,0,0,0,0,0,
0,1,2,3,4,5,6,7,8,8,8,8,8,8,8,8,8,
0,0,0,0,0,0,0,0,0,0,0,0,0,0,0,0,0,
0,0,0,0,0,0,0,0,0,0,0,0,0,0,0,0,0,
0,1,2,3,4,5,6,7,7,7,7,7,7,7,7,7,7,
0,1,2,3,4,5,6,7,7,7,7,7,7,7,7,7,7,
0,0,0,0,0,0,0,0,0,0,0,0,0,0,0,0,0,
0,1,2,2,2,2,2,2,2,2,2,2,2,2,2,2,2,
0,1,2,3,4,5,5,5,5,5,5,5,5,5,5,5,5,
0,1,3,4,5,6,7,8,9,10,11,12,13,14,15,17,21,
0,1,1,1,1,1,1,1,1,1,1,1,1,1,1,1,1,
0,1,2,3,4,5,6,7,8,9,9,9,9,9,9,9,9,
0,1,2,3,4,4,4,4,4,4,4,4,4,4,4,4,4,
0,0,0,0,0,0,0,0,0,0,0,0,0,0,0,0,0,
0,1,2,3,4,5,6,7,8,9,10,11,11,11,11,11,11,
0,1,2,2,2,2,2,2,2,2,2,2,2,2,2,2,2,
0,1,2,3,4,5,6,7,8,9,10,11,12,13,14,22,22,
0,1,2,3,4,5,5,5,5,5,5,5,5,5,5,5,5,
0,1,2,3,4,5,6,7,7,7,7,7,7,7,7,7,7,
0,1,2,3,4,5,6,7,8,9,10,10,10,10,10,10,10,
0,1,2,2,2,2,2,2,2,2,2,2,2,2,2,2,2,
0,0,0,0,0,0,0,0,0,0,0,0,0,0,0,0,0,
0,0,0,0,0,0,0,0,0,0,0,0,0,0,0,0,0,
0,0,0,0,0,0,0,0,0,0,0,0,0,0,0,0,0,
0,0,0,0,0,0,0,0,0,0,0,0,0,0,0,0,0,
0,1,2,3,4,5,6,7,8,9,10,11,12,13,14,15,18,
0,0,0,0,0,0,0,0,0,0,0,0,0,0,0,0,0,
0,1,2,3,4,5,6,7,8,9,10,11,11,11,11,11,11,
0,0,0,0,0,0,0,0,0,0,0,0,0,0,0,0,0,
0,1,2,3,4,5,6,7,8,9,10,11,11,11,11,11,11,
0,1,2,3,4,5,6,7,8,9,9,9,9,9,9,9,9,
0,0,0,0,0,0,0,0,0,0,0,0,0,0,0,0,0,
0,1,7,7,7,7,7,7,7,7,7,7,7,7,7,7,7,
0,0,0,0,0,0,0,0,0,0,0,0,0,0,0,0,0,
0,1,10,11,12,13,14,15,16,17,18,19,20,21,21,21,21,
0,1,2,3,4,4,4,4,4,4,4,4,4,4,4,4,4,
0,1,2,2,2,2,2,2,2,2,2,2,2,2,2,2,2,
0,0,0,0,0,0,0,0,0,0,0,0,0,0,0,0,0,
0,0,0,0,0,0,0,0,0,0,0,0,0,0,0,0,0,
0,1,2,3,4,5,6,7,8,9,10,11,12,24,24,24,24,
0,1,2,3,4,5,6,7,8,9,10,11,12,13,26,26,26,
0,1,2,3,4,5,6,7,8,9,9,9,9,9,9,9,9,
0,0,0,0,0,0,0,0,0,0,0,0,0,0,0,0,0,
0,0,0,0,0,0,0,0,0,0,0,0,0,0,0,0,0,
0,1,2,3,4,4,4,4,4,4,4,4,4,4,4,4,4,
0,1,12,13,14,15,16,17,21,22,23,24,25,59,60,63,63,
0,1,2,3,4,5,6,7,8,9,10,11,12,13,
0,1,2,3,4,5,10,11,12,13,14,14,14,14,14,14,14,
0,1,2,3,4,5,6,7,8,9,10,11,12,21,21,21,21,
0,1,2,3,4,4,4,4,4,4,4,4,4,4,4,4,4,
0,1,3,4,5,6,7,8,9,10,11,12,13,14,18,19,34,
0,1,3,4,5,6,7,8,9,10,11,12,13,14,15,26,26,
0,1,2,3,4,5,6,7,8,9,10,11,12,13,13,13,13,
0,0,0,0,0,0,0,0,0,0,0,0,0,0,0,0,0,
0,1,1,1,1,1,1,1,1,1,1,1,1,1,1,1,1,
0,1,1,1,1,1,1,1,1,1,1,1,1,1,1,1,1,
0,0,0,0,0,0,0,0,0,0,0,0,0,0,0,0,0,
0,1,2,3,4,4,4,4,4,4,4,4,4,4,4,4,4,
0,1,7,8,9,10,11,12,12,12,12,12,12,12,12,12,12,
0,0,0,0,0,0,0,0,0,0,0,0,0,0,0,0,0,
0,0,0,0,0,0,0,0,0,0,0,0,0,0,0,0,0,
0,1,12,
0,1,2,3,4,5,6,7,8,9,10,11,12,13,14,15,41,
0,0,0,0,0,0,0,0,0,0,0,0,0,0,0,0,0,
0,1,2,3,4,5,6,7,8,9,9,9,9,9,9,9,9,
0,0,0,0,0,0,0,0,0,0,0,0,0,0,0,0,0,
0,1,1,1,1,1,1,1,1,1,1,1,1,1,1,1,1,
0,1,2,3,4,5,6,7,8,8,8,8,8,8,8,8,8,
0,1,1,1,1,1,1,1,1,1,1,1,1,1,1,1,1,
0,1,2,3,4,5,6,7,8,9,10,11,16,17,18,19,26,
0,1,2,3,4,5,5,5,5,5,5,5,5,5,5,5,5,
0,1,2,3,4,5,6,7,8,9,10,11,12,13,14,26,56,
0,1,2,3,4,5,6,7,8,8,8,8,8,8,8,8,8,
0,1,1,1,1,1,1,1,1,1,1,1,1,1,1,1,1,
0,1,1,1,1,1,1,1,1,1,1,1,1,1,1,1,1,
0,0,0,0,0,0,0,0,0,0,0,0,0,0,0,0,0,
0,1,2,3,4,5,6,7,8,9,9,9,9,9,9,9,9,
0,1,1,1,1,1,1,1,1,1,1,1,1,1,1,1,1,
0,1,2,3,3,3,3,3,3,3,3,3,3,3,3,3,3,
0,0,0,0,0,0,0,0,0,0,0,0,0,0,0,0,0,
0,1,5,6,7,8,9,10,11,12,13,14,15,16,17,18,26,
0,1,1,1,1,1,1,1,1,1,1,1,1,1,1,1,1,
